修業年限	時間表現-期間-期間_その他			
10月11日	時間表現-時間-日付表現			
10月17日	時間表現-時間-日付表現			
10月1日	時間表現-時間-日付表現			
10月20日	時間表現-時間-日付表現			
10月5日	時間表現-時間-日付表現			
11月30日	時間表現-時間-日付表現			
11月3日	時間表現-時間-日付表現			
12月15日	時間表現-時間-日付表現			
12月1日	時間表現-時間-日付表現			
12月20日	時間表現-時間-日付表現			
12月31日	時間表現-時間-日付表現			
1552年	時間表現-時間-日付表現			
1599年	時間表現-時間-日付表現			
1612年	時間表現-時間-日付表現			
1640年	時間表現-時間-日付表現			
1654年	時間表現-時間-日付表現			
1669年	時間表現-時間-日付表現			
16世紀	時間表現-時間-日付表現			
1782年	時間表現-時間-日付表現			
1810年	時間表現-時間-日付表現			
1855年	時間表現-時間-日付表現			
1889年	時間表現-時間-日付表現			
1892年	時間表現-時間-日付表現			
18世紀	時間表現-時間-日付表現			
1906年	時間表現-時間-日付表現			
1910年	時間表現-時間-日付表現			
1912年	時間表現-時間-日付表現			
1919年	時間表現-時間-日付表現			
1922年	時間表現-時間-日付表現			
1923年	時間表現-時間-日付表現			
1927年	時間表現-時間-日付表現			
1934年	時間表現-時間-日付表現			
1935年	時間表現-時間-日付表現			
1938年	時間表現-時間-日付表現			
1940年	時間表現-時間-日付表現			
1941年	時間表現-時間-日付表現			
1944年	時間表現-時間-日付表現			
1948年	時間表現-時間-日付表現			
1949年	時間表現-時間-日付表現			
1950年	時間表現-時間-日付表現			
1951年	時間表現-時間-日付表現			
1953年	時間表現-時間-日付表現			
1954年	時間表現-時間-日付表現			
1955年	時間表現-時間-日付表現			
1956年	時間表現-時間-日付表現			
1958年	時間表現-時間-日付表現			
1959年	時間表現-時間-日付表現			
1963年	時間表現-時間-日付表現			
1964年	時間表現-時間-日付表現			
1967年	時間表現-時間-日付表現			
1968年	時間表現-時間-日付表現			
1969年	時間表現-時間-日付表現			
1970年	時間表現-時間-日付表現			
1974年	時間表現-時間-日付表現			
1975年	時間表現-時間-日付表現			
1976年	時間表現-時間-日付表現			
1977年	時間表現-時間-日付表現			
1978年	時間表現-時間-日付表現			
1979年	時間表現-時間-日付表現			
1980年	時間表現-時間-日付表現			
1982年	時間表現-時間-日付表現			
1983年	時間表現-時間-日付表現			
1984年	時間表現-時間-日付表現			
1985年	時間表現-時間-日付表現			
1988年	時間表現-時間-日付表現			
1989年	時間表現-時間-日付表現			
1990年	時間表現-時間-日付表現			
1991年	時間表現-時間-日付表現			
1992年	時間表現-時間-日付表現			
1993年	時間表現-時間-日付表現			
1994年	時間表現-時間-日付表現			
1995年	時間表現-時間-日付表現			
1996年	時間表現-時間-日付表現			
1997年	時間表現-時間-日付表現			
1998年	時間表現-時間-日付表現			
1月1日	時間表現-時間-日付表現			
1月5日	時間表現-時間-日付表現			
2000年	時間表現-時間-日付表現			
2001年	時間表現-時間-日付表現			
2002年	時間表現-時間-日付表現			
2003年	時間表現-時間-日付表現			
2004年	時間表現-時間-日付表現			
2005年	時間表現-時間-日付表現			
2006年	時間表現-時間-日付表現			
2009年	時間表現-時間-日付表現			
2012年	時間表現-時間-日付表現			
2月11日	時間表現-時間-日付表現			
2月28日	時間表現-時間-日付表現			
2月7日	時間表現-時間-日付表現			
3月13日	時間表現-時間-日付表現			
3月1日	時間表現-時間-日付表現			
3月24日	時間表現-時間-日付表現			
4月12日	時間表現-時間-日付表現			
4月15日	時間表現-時間-日付表現			
4月1日	時間表現-時間-日付表現			
4月29日	時間表現-時間-日付表現			
6月15日	時間表現-時間-日付表現			
6月3日	時間表現-時間-日付表現			
7月1日	時間表現-時間-日付表現			
8月1日	時間表現-時間-日付表現			
8月23日	時間表現-時間-日付表現			
9月30日	時間表現-時間-日付表現			
単位時間	時間表現-時間表現_その他			
カトリック改革	名前-イベント名-イベント名_その他			
加藤の乱	名前-イベント名-イベント名_その他			
対抗改革	名前-イベント名-イベント名_その他			
ガリポリの戦い	名前-イベント名-戦争名			
法定合併協議会	名前-イベント名-催し物名-会議名			
FIFAワールドカップ	名前-イベント名-催し物名-大会名			
ちばぎんカップ	名前-イベント名-催し物名-大会名			
サンワバンクカップ	名前-イベント名-催し物名-大会名			
ゼロックス・スーパーカップ	名前-イベント名-催し物名-大会名			
グレーター・トウキョウ・フェスティバル	名前-イベント名-催し物名-催し物名_その他			
ジャイアン・リサイタル	名前-イベント名-催し物名-催し物名_その他			
全国植樹祭	名前-イベント名-催し物名-催し物名_その他			
前期課程	名前-イベント名-催し物名-催し物名_その他			
専門課程	名前-イベント名-催し物名-催し物名_その他			
後期課程	名前-イベント名-催し物名-催し物名_その他			
課程	名前-イベント名-催し物名-催し物名_その他			
高等課程	名前-イベント名-催し物名-催し物名_その他			
ガーラ湯沢駅	名前-施設名-GOE-駅名-電車駅名			
三原駅	名前-施設名-GOE-駅名-電車駅名			
上呂駅	名前-施設名-GOE-駅名-電車駅名			
上野駅	名前-施設名-GOE-駅名-電車駅名			
中部国際空港駅	名前-施設名-GOE-駅名-電車駅名			
丸亀駅	名前-施設名-GOE-駅名-電車駅名			
久喜駅	名前-施設名-GOE-駅名-電車駅名			
久留米駅	名前-施設名-GOE-駅名-電車駅名			
亀岡駅	名前-施設名-GOE-駅名-電車駅名			
五稜郭駅	名前-施設名-GOE-駅名-電車駅名			
京都駅	名前-施設名-GOE-駅名-電車駅名			
仙台駅	名前-施設名-GOE-駅名-電車駅名			
佐倉駅	名前-施設名-GOE-駅名-電車駅名			
八幡浜駅	名前-施設名-GOE-駅名-電車駅名			
八戸駅	名前-施設名-GOE-駅名-電車駅名			
八雲駅	名前-施設名-GOE-駅名-電車駅名			
函南駅	名前-施設名-GOE-駅名-電車駅名			
函館駅	名前-施設名-GOE-駅名-電車駅名			
加斗駅	名前-施設名-GOE-駅名-電車駅名			
勝原駅	名前-施設名-GOE-駅名-電車駅名			
千葉駅	名前-施設名-GOE-駅名-電車駅名			
南加木屋駅	名前-施設名-GOE-駅名-電車駅名			
南安城駅	名前-施設名-GOE-駅名-電車駅名			
南酒々井駅	名前-施設名-GOE-駅名-電車駅名			
博多南駅	名前-施設名-GOE-駅名-電車駅名			
博多駅	名前-施設名-GOE-駅名-電車駅名			
名古屋駅	名前-施設名-GOE-駅名-電車駅名			
名立駅	名前-施設名-GOE-駅名-電車駅名			
名鉄名古屋駅	名前-施設名-GOE-駅名-電車駅名			
君津駅	名前-施設名-GOE-駅名-電車駅名			
和田山駅	名前-施設名-GOE-駅名-電車駅名			
品川駅	名前-施設名-GOE-駅名-電車駅名			
国府宮駅	名前-施設名-GOE-駅名-電車駅名			
土呂駅	名前-施設名-GOE-駅名-電車駅名			
坂出駅	名前-施設名-GOE-駅名-電車駅名			
城崎温泉駅	名前-施設名-GOE-駅名-電車駅名			
多度津駅	名前-施設名-GOE-駅名-電車駅名			
大分駅	名前-施設名-GOE-駅名-電車駅名			
大崎駅	名前-施設名-GOE-駅名-電車駅名			
大牟田駅	名前-施設名-GOE-駅名-電車駅名			
大網駅	名前-施設名-GOE-駅名-電車駅名			
大阪駅	名前-施設名-GOE-駅名-電車駅名			
大館駅	名前-施設名-GOE-駅名-電車駅名			
天橋立駅	名前-施設名-GOE-駅名-電車駅名			
太田川駅	名前-施設名-GOE-駅名-電車駅名			
奈古駅	名前-施設名-GOE-駅名-電車駅名			
宇佐美駅	名前-施設名-GOE-駅名-電車駅名			
宇和島駅	名前-施設名-GOE-駅名-電車駅名			
宇多津駅	名前-施設名-GOE-駅名-電車駅名			
宇田郷駅	名前-施設名-GOE-駅名-電車駅名			
宇都宮駅	名前-施設名-GOE-駅名-電車駅名			
宮原駅	名前-施設名-GOE-駅名-電車駅名			
宮崎空港駅	名前-施設名-GOE-駅名-電車駅名			
宮津駅	名前-施設名-GOE-駅名-電車駅名			
尾久駅	名前-施設名-GOE-駅名-電車駅名			
尾張横須賀駅	名前-施設名-GOE-駅名-電車駅名			
山形駅	名前-施設名-GOE-駅名-電車駅名			
岐阜駅	名前-施設名-GOE-駅名-電車駅名			
岡山駅	名前-施設名-GOE-駅名-電車駅名			
川崎駅	名前-施設名-GOE-駅名-電車駅名			
広島駅	名前-施設名-GOE-駅名-電車駅名			
徳島駅	名前-施設名-GOE-駅名-電車駅名			
成東駅	名前-施設名-GOE-駅名-電車駅名			
成田空港駅	名前-施設名-GOE-駅名-電車駅名			
成田駅	名前-施設名-GOE-駅名-電車駅名			
新八代駅	名前-施設名-GOE-駅名-電車駅名			
新大阪駅	名前-施設名-GOE-駅名-電車駅名			
新安城駅	名前-施設名-GOE-駅名-電車駅名			
新宿駅	名前-施設名-GOE-駅名-電車駅名			
新山口駅	名前-施設名-GOE-駅名-電車駅名			
新川崎駅	名前-施設名-GOE-駅名-電車駅名			
新庄駅	名前-施設名-GOE-駅名-電車駅名			
新横浜駅	名前-施設名-GOE-駅名-電車駅名			
新水俣駅	名前-施設名-GOE-駅名-電車駅名			
新潟駅	名前-施設名-GOE-駅名-電車駅名			
新神戸駅	名前-施設名-GOE-駅名-電車駅名			
木更津駅	名前-施設名-GOE-駅名-電車駅名			
本千葉駅	名前-施設名-GOE-駅名-電車駅名			
札幌駅	名前-施設名-GOE-駅名-電車駅名			
来宮駅	名前-施設名-GOE-駅名-電車駅名			
東京駅	名前-施設名-GOE-駅名-電車駅名			
東千葉駅	名前-施設名-GOE-駅名-電車駅名			
東室蘭駅	名前-施設名-GOE-駅名-電車駅名			
東岡崎駅	名前-施設名-GOE-駅名-電車駅名			
東能代駅	名前-施設名-GOE-駅名-電車駅名			
横浜駅	名前-施設名-GOE-駅名-電車駅名			
水戸駅	名前-施設名-GOE-駅名-電車駅名			
池袋駅	名前-施設名-GOE-駅名-電車駅名			
沼津駅	名前-施設名-GOE-駅名-電車駅名			
浜野駅	名前-施設名-GOE-駅名-電車駅名			
渋谷駅	名前-施設名-GOE-駅名-電車駅名			
熊本駅	名前-施設名-GOE-駅名-電車駅名			
熊谷駅	名前-施設名-GOE-駅名-電車駅名			
熱海駅	名前-施設名-GOE-駅名-電車駅名			
牟岐駅	名前-施設名-GOE-駅名-電車駅名			
益田駅	名前-施設名-GOE-駅名-電車駅名			
盛岡駅	名前-施設名-GOE-駅名-電車駅名			
直方駅	名前-施設名-GOE-駅名-電車駅名			
知多半田駅	名前-施設名-GOE-駅名-電車駅名			
知立駅	名前-施設名-GOE-駅名-電車駅名			
石原駅 (京都府)	名前-施設名-GOE-駅名-電車駅名			
石原駅 (埼玉県)	名前-施設名-GOE-駅名-電車駅名			
神宮前駅	名前-施設名-GOE-駅名-電車駅名			
禅昌寺駅	名前-施設名-GOE-駅名-電車駅名			
福知山駅	名前-施設名-GOE-駅名-電車駅名			
秋田駅	名前-施設名-GOE-駅名-電車駅名			
窪川駅	名前-施設名-GOE-駅名-電車駅名			
立川駅	名前-施設名-GOE-駅名-電車駅名			
米沢駅	名前-施設名-GOE-駅名-電車駅名			
蘇我駅	名前-施設名-GOE-駅名-電車駅名			
行橋駅	名前-施設名-GOE-駅名-電車駅名			
西大井駅	名前-施設名-GOE-駅名-電車駅名			
西尾駅	名前-施設名-GOE-駅名-電車駅名			
西明石駅	名前-施設名-GOE-駅名-電車駅名			
豊橋駅	名前-施設名-GOE-駅名-電車駅名			
赤羽駅	名前-施設名-GOE-駅名-電車駅名			
越後湯沢駅	名前-施設名-GOE-駅名-電車駅名			
軽井沢駅	名前-施設名-GOE-駅名-電車駅名			
那須塩原駅	名前-施設名-GOE-駅名-電車駅名			
酒々井駅	名前-施設名-GOE-駅名-電車駅名			
錦糸町駅	名前-施設名-GOE-駅名-電車駅名			
鎌取駅	名前-施設名-GOE-駅名-電車駅名			
長岡駅	名前-施設名-GOE-駅名-電車駅名			
長野駅	名前-施設名-GOE-駅名-電車駅名			
門司駅	名前-施設名-GOE-駅名-電車駅名			
門島駅	名前-施設名-GOE-駅名-電車駅名			
門松駅	名前-施設名-GOE-駅名-電車駅名			
門沢橋駅	名前-施設名-GOE-駅名-電車駅名			
門真南駅	名前-施設名-GOE-駅名-電車駅名			
門真市駅	名前-施設名-GOE-駅名-電車駅名			
阿波池田駅	名前-施設名-GOE-駅名-電車駅名			
青森駅	名前-施設名-GOE-駅名-電車駅名			
須ヶ口駅	名前-施設名-GOE-駅名-電車駅名			
飛騨古川駅	名前-施設名-GOE-駅名-電車駅名			
飛騨宮田駅	名前-施設名-GOE-駅名-電車駅名			
飛騨萩原駅	名前-施設名-GOE-駅名-電車駅名			
香取駅	名前-施設名-GOE-駅名-電車駅名			
高山駅	名前-施設名-GOE-駅名-電車駅名			
高崎駅	名前-施設名-GOE-駅名-電車駅名			
高知駅	名前-施設名-GOE-駅名-電車駅名			
鳥取駅	名前-施設名-GOE-駅名-電車駅名			
鹿児島中央駅	名前-施設名-GOE-駅名-電車駅名			
鹿渡駅	名前-施設名-GOE-駅名-電車駅名			
外国人学校	名前-施設名-GOE-学校名	固有名詞ではない		
専修学校	名前-施設名-GOE-学校名	固有名詞ではない		
専門学校	名前-施設名-GOE-学校名	固有名詞ではない		
私立大学	名前-施設名-GOE-学校名	固有名詞ではない		
高等専修学校	名前-施設名-GOE-学校名	固有名詞ではない		
高等専門学校	名前-施設名-GOE-学校名	固有名詞ではない		
学習塾	名前-施設名-GOE-学校名	固有名詞ではない		
ナショナル・スクール	名前-施設名-GOE-学校名	固有名詞ではない		
ガートン・カレッジ	名前-施設名-GOE-学校名			
広島国際学院大学	名前-施設名-GOE-学校名			
東京都立蔵前工業高等学校	名前-施設名-GOE-学校名			
長崎海軍伝習所	名前-施設名-GOE-学校名			
市役所	名前-施設名-GOE-公共機関名	固有名詞ではない		
久津八幡宮	名前-施設名-GOE-神社寺名			
禅昌寺	名前-施設名-GOE-神社寺名			
カドリードミニオン	名前-施設名-GOE-遊園施設名			
南飛騨国際健康保養地	名前-施設名-GOE-遊園施設名			
熊谷スポーツ文化公園	名前-施設名-公園名			
国立霞ヶ丘陸上競技場	名前-施設名-スポーツ施設名			
北陸新幹線	名前-施設名-路線名-電車路線名			
湘南新宿ライン	名前-施設名-路線名-電車路線名			
長野新幹線	名前-施設名-路線名-電車路線名			
りんかい線	名前-施設名-路線名-電車路線名			
北海道道42号八雲北檜山線	名前-施設名-路線名-道路名			
国道191号	名前-施設名-路線名-道路名			
国道195号	名前-施設名-路線名-道路名			
国道257号	名前-施設名-路線名-道路名			
国道32号	名前-施設名-路線名-道路名			
国道33号	名前-施設名-路線名-道路名			
国道41号	名前-施設名-路線名-道路名			
国道55号	名前-施設名-路線名-道路名			
国道56号	名前-施設名-路線名-道路名			
国道8号	名前-施設名-路線名-道路名			
電子	名前-自然物名-自然物名_その他			
種子	名前-自然物名-生物名-植物部位名			
葉	名前-自然物名-生物名-植物部位名			
観葉植物	名前-自然物名-生物名-植物名	固有名詞ではない		
サクラ	名前-自然物名-生物名-植物名			
シソ科	名前-自然物名-生物名-植物名			
ガドレイン酸	名前-自然物名-生物名-生物名_その他			
アカエリミフウズラ	名前-自然物名-生物名-動物名-脊椎動物-鳥類			
コシグロミフウズラ	名前-自然物名-生物名-動物名-脊椎動物-鳥類			
ササフミフウズラ	名前-自然物名-生物名-動物名-脊椎動物-鳥類			
スンバミフウズラ	名前-自然物名-生物名-動物名-脊椎動物-鳥類			
セアカミフウズラ	名前-自然物名-生物名-動物名-脊椎動物-鳥類			
チョウセンミフウズラ	名前-自然物名-生物名-動物名-脊椎動物-鳥類			
ハイムネミフウズラ	名前-自然物名-生物名-動物名-脊椎動物-鳥類			
ハジロミフウズラ	名前-自然物名-生物名-動物名-脊椎動物-鳥類			
ヒメミフウズラ	名前-自然物名-生物名-動物名-脊椎動物-鳥類			
フィリピンヒメミフウズラ	名前-自然物名-生物名-動物名-脊椎動物-鳥類			
ホオアカミフウズラ	名前-自然物名-生物名-動物名-脊椎動物-鳥類			
マダガスカルミフウズラ	名前-自然物名-生物名-動物名-脊椎動物-鳥類			
マメミフウズラ	名前-自然物名-生物名-動物名-脊椎動物-鳥類			
ミフウズラ	名前-自然物名-生物名-動物名-脊椎動物-鳥類			
ムナグロミフウズラ	名前-自然物名-生物名-動物名-脊椎動物-鳥類			
ムネアカミフウズラ	名前-自然物名-生物名-動物名-脊椎動物-鳥類			
ルソンミフウズラ	名前-自然物名-生物名-動物名-脊椎動物-鳥類			
ナマコ綱	名前-自然物名-生物名-動物名-無脊椎動物-無脊椎動物_その他			
アルカリ金属	名前-自然物名-物質名			
カドニウム	名前-自然物名-物質名			
半家	名前-称号名-地位名			
参議院議長	名前-称号名-地位名			
専門士	名前-称号名-地位名			
従二位	名前-称号名-地位名			
戦国大名	名前-称号名-地位名			
文部科学大臣	名前-称号名-地位名			
極官	名前-称号名-地位名			
権中納言	名前-称号名-地位名			
衆議院議長	名前-称号名-地位名			
高校教師	名前-職業名	名前-製品名-芸術名-番組名	名前-製品名-芸術名-映画名	
お笑いタレント	名前-職業名			
サッカー選手	名前-職業名			
タレント	名前-職業名			
フリーアナウンサー	名前-職業名			
モデル	名前-職業名			
二輪レーサー	名前-職業名			
作家	名前-職業名			
俳優	名前-職業名			
哲学者	名前-職業名			
声優	名前-職業名			
女優	名前-職業名			
建築家	名前-職業名			
心理学者	名前-職業名			
情報員	名前-職業名			
政治家	名前-職業名			
数学者	名前-職業名			
映画監督	名前-職業名			
棋士 (将棋)	名前-職業名			
歌手	名前-職業名			
漫画家	名前-職業名			
画家	名前-職業名			
神学者	名前-職業名			
経済学者	名前-職業名			
考古学者	名前-職業名			
芸人	名前-職業名			
行政学者	名前-職業名			
評論家	名前-職業名			
軍人	名前-職業名			
野球解説者	名前-職業名			
野球選手	名前-職業名			
百太郎	名前-人名	名前-製品名-キャラクター名		
カード	名前-人名	名前-製品名-食べ物名		
加藤	名前-人名	名前-組織名-企業名		
アナーキー	名前-人名	名前-組織名-組織名_その他		
大阪	名前-人名	名前-地名-GPE-GPE_その他		
コルフ	名前-人名	名前-地名-GPE-都道府県州名	名前-製品名-競技名	
EPO	名前-人名			
MEIMU	名前-人名			
SAKURA	名前-人名			
SAYAKA	名前-人名			
Sowelu	名前-人名			
TETSU	名前-人名			
あいだもも	名前-人名			
あおい輝彦	名前-人名			
うしだゆうじ	名前-人名			
おとといきたろう	名前-人名			
かどたひろし	名前-人名			
かまやつひろし	名前-人名			
たてかべ和也	名前-人名			
ときた洸一	名前-人名			
まきいづみ	名前-人名			
みずきたつ	名前-人名			
やくみつる	名前-人名			
やすだひろし	名前-人名			
エディ・マーフィ	名前-人名			
カッテンディーケ	名前-人名			
カトゥッルス	名前-人名			
カトゥルス	名前-人名			
カトキハジメ	名前-人名			
カトリーヌ・ド・メディシス	名前-人名			
カトリーヌ・ド・メディチ	名前-人名			
カート・アングル	名前-人名			
カート・コバーン	名前-人名			
カート・シリング	名前-人名			
カート・ヴォネガット	名前-人名			
ガイウス・ウァレリウス・カトゥルス	名前-人名			
ガートルード・ベル	名前-人名			
クリストファー・ウォーケン	名前-人名			
グッチ裕三	名前-人名			
ゲーテ	名前-人名			
サトウハチロー	名前-人名			
シャキール・オニール	名前-人名			
ジェラール・ウリエ	名前-人名			
ジャイ子	名前-人名			
ジョン・ベルーシ	名前-人名			
ダン・エイクロイド	名前-人名			
デーモン小暮	名前-人名			
トム・ハンクス	名前-人名			
ニコラ・アネルカ	名前-人名			
ノビスケ	名前-人名			
ハーフェズ・アル＝アサド	名前-人名			
ビル・マーレイ	名前-人名			
ビートたけし	名前-人名			
ホルティ・ミクローシュ	名前-人名			
マイク・マイヤーズ	名前-人名			
マイケル・ジョーダン	名前-人名			
マキノ佐代子	名前-人名			
マルク・ヴィヴィアン・フォエ	名前-人名			
マルチナ・ヒンギス	名前-人名			
ミッキーカーチス	名前-人名			
モト冬樹	名前-人名			
モニカ・セレシュ	名前-人名			
モンテスキュー	名前-人名			
ヨシフ・スターリン	名前-人名			
三島由紀夫	名前-人名			
三木眞一郎	名前-人名			
三石琴乃	名前-人名			
三谷幸喜	名前-人名			
上戸彩	名前-人名			
上田誠也	名前-人名			
下河辺三史	名前-人名			
下河辺俊行	名前-人名			
下河辺孫一	名前-人名			
下河辺建二	名前-人名			
与謝野馨	名前-人名			
中丸雄一	名前-人名			
中原れい	名前-人名			
中山忍	名前-人名			
中山美穂	名前-人名			
中島裕翔	名前-人名			
中川善之助	名前-人名			
中川昭一	名前-人名			
中川翔子	名前-人名			
中村梅吉	名前-人名			
中村紘子	名前-人名			
中森明菜	名前-人名			
中田喜直	名前-人名			
串田嘉男	名前-人名			
久米大作	名前-人名			
久織ちまき	名前-人名			
亀井絵里	名前-人名			
亀梨和也	名前-人名			
二階堂高嗣	名前-人名			
五十嵐こずえ	名前-人名			
五島昇	名前-人名			
井上大助	名前-人名			
井上陽水	名前-人名			
井口資仁	名前-人名			
交野時貞	名前-人名			
人見元基	名前-人名			
今川泰宏	名前-人名			
今西隆志	名前-人名			
今野敏	名前-人名			
仲代達矢	名前-人名			
仲根かすみ	名前-人名			
伊東ゆかり	名前-人名			
伊藤誠	名前-人名			
伊藤静	名前-人名			
伊野尾慧	名前-人名			
佐伯祐里	名前-人名			
佐竹義利	名前-人名			
佐藤茂	名前-人名			
佐藤謙一郎	名前-人名			
佐野元春	名前-人名			
倉本聰	名前-人名			
元良誠三	名前-人名			
入江昭	名前-人名			
入江相政	名前-人名			
兼子一	名前-人名			
前田利家	名前-人名			
功刀俊洋	名前-人名			
加瀬充子	名前-人名			
加瀬邦彦	名前-人名			
加登屋みつる	名前-人名			
加藤あい	名前-人名			
加藤いづみ	名前-人名			
加藤みづき	名前-人名			
加藤みどり	名前-人名			
加藤ミリヤ	名前-人名			
加藤ローサ	名前-人名			
加藤一二三	名前-人名			
加藤三郎	名前-人名			
加藤与五郎	名前-人名			
加藤久	名前-人名			
加藤久仁彦	名前-人名			
加藤亜希子	名前-人名			
加藤伸一	名前-人名			
加藤伸吉	名前-人名			
加藤保憲	名前-人名			
加藤修	名前-人名			
加藤健	名前-人名			
加藤優子	名前-人名			
加藤充	名前-人名			
加藤光大	名前-人名			
加藤光泰	名前-人名			
加藤公一	名前-人名			
加藤六月	名前-人名			
加藤典洋	名前-人名			
加藤剛	名前-人名			
加藤勝康	名前-人名			
加藤千佳	名前-人名			
加藤千洋	名前-人名			
加藤博一	名前-人名			
加藤友三郎	名前-人名			
加藤周一	名前-人名			
加藤和也	名前-人名			
加藤和也 (ひばりプロダクション)	名前-人名			
加藤和彦	名前-人名			
加藤和樹	名前-人名			
加藤哲太郎	名前-人名			
加藤哲郎	名前-人名			
加藤哲郎 (学者)	名前-人名			
加藤哲郎 (野球選手)	名前-人名			
加藤嘉	名前-人名			
加藤嘉明	名前-人名			
加藤四郎	名前-人名			
加藤夏希	名前-人名			
加藤大治郎	名前-人名			
加藤大治郎 (レーサー)	名前-人名			
加藤大治郎 (俳優)	名前-人名			
加藤奈々絵	名前-人名			
加藤寛	名前-人名			
加藤将之	名前-人名			
加藤小百合	名前-人名			
加藤尚武	名前-人名			
加藤常昭	名前-人名			
加藤康介	名前-人名			
加藤康裕	名前-人名			
加藤弘之	名前-人名			
加藤徹	名前-人名			
加藤忠広	名前-人名			
加藤恭子	名前-人名			
加藤慶之	名前-人名			
加藤成亮	名前-人名			
加藤文	名前-人名			
加藤文太郎	名前-人名			
加藤明允	名前-人名			
加藤明利	名前-人名			
加藤明子	名前-人名			
加藤明成	名前-人名			
加藤明日美	名前-人名			
加藤晃	名前-人名			
加藤景廉	名前-人名			
加藤晴彦	名前-人名			
加藤朗	名前-人名			
加藤木賢志	名前-人名			
加藤正之	名前-人名			
加藤正二	名前-人名			
加藤正夫	名前-人名			
加藤武治	名前-人名			
加藤沢男	名前-人名			
加藤治	名前-人名			
加藤治郎	名前-人名			
加藤治郎 (歌人)	名前-人名			
加藤泰	名前-人名			
加藤浩次	名前-人名			
加藤淳	名前-人名			
加藤清尚	名前-人名			
加藤清正	名前-人名			
加藤由加利	名前-人名			
加藤由香	名前-人名			
加藤登紀子	名前-人名			
加藤直之	名前-人名			
加藤真由	名前-人名			
加藤秀一	名前-人名			
加藤秀俊	名前-人名			
加藤節	名前-人名			
加藤精三	名前-人名			
加藤紀子	名前-人名			
加藤紘一	名前-人名			
加藤美佳	名前-人名			
加藤美由紀	名前-人名			
加藤芳郎	名前-人名			
加藤英司	名前-人名			
加藤茶	名前-人名			
加藤裕介	名前-人名			
加藤諦三	名前-人名			
加藤貞泰	名前-人名			
加藤貴子	名前-人名			
加藤邦彦	名前-人名			
加藤鐐五郎	名前-人名			
加藤陽子	名前-人名			
加藤隆弘	名前-人名			
加藤雅也	名前-人名			
加藤高明	名前-人名			
加藤高道	名前-人名			
加藤鷹	名前-人名			
勝田正之	名前-人名			
北島康介	名前-人名			
北杜夫	名前-人名			
北爪宏幸	名前-人名			
北野大	名前-人名			
千聖	名前-人名			
千葉智宏	名前-人名			
原文兵衛	名前-人名			
原田泰造	名前-人名			
原田祐希	名前-人名			
古内東子	名前-人名			
古在由秀	名前-人名			
古屋圭司	名前-人名			
古舘伊知郎	名前-人名			
古都ひかる	名前-人名			
可愛ゆう	名前-人名			
吉住梢	名前-人名			
吉永小百合	名前-人名			
吉沢明歩	名前-人名			
吉田茂	名前-人名			
吉阪隆正	名前-人名			
向田邦子	名前-人名			
呉文聰	名前-人名			
呉秀三	名前-人名			
呉茂一	名前-人名			
和泉宏隆	名前-人名			
和泉聖治	名前-人名			
国分佐智子	名前-人名			
團伊玖磨	名前-人名			
土井隆雄	名前-人名			
土屋礼央	名前-人名			
土門廣	名前-人名			
坂崎幸之助	名前-人名			
坪井忠二	名前-人名			
坪井智哉	名前-人名			
坪井木の実	名前-人名			
坪井正五郎	名前-人名			
坪井誠太郎	名前-人名			
堀江慶	名前-人名			
堀江由衣	名前-人名			
堀源一郎	名前-人名			
堤清二	名前-人名			
堤義明	名前-人名			
塩野七生	名前-人名			
増岡隆一	名前-人名			
夏元雅人	名前-人名			
夏目房之介	名前-人名			
夏目漱石	名前-人名			
夏野こおり	名前-人名			
大和田美帆	名前-人名			
大塚寧々	名前-人名			
大山加奈	名前-人名			
大島公一	名前-人名			
大島千歳	名前-人名			
大森彌	名前-人名			
大沢清輝	名前-人名			
大河内一楼	名前-人名			
大河内奈々子	名前-人名			
大貫妙子	名前-人名			
天地真理	名前-人名			
如月カレン	名前-人名			
安井謙	名前-人名			
安彦良和	名前-人名			
安田忠夫	名前-人名			
安田成美	名前-人名			
安藤和津	名前-人名			
安西孝之	名前-人名			
宮崎あおい	名前-人名			
宮本一毅	名前-人名			
宮本武蔵	名前-人名			
宮沢りえ	名前-人名			
宮澤喜一	名前-人名			
宮田和弥	名前-人名			
富山治夫	名前-人名			
富田弘一郎	名前-人名			
富野由悠季	名前-人名			
寺田寅彦	名前-人名			
小倉ありす	名前-人名			
小室哲哉	名前-人名			
小尾信彌	名前-人名			
小島麻由美	名前-人名			
小川明日香	名前-人名			
小平桂一	名前-人名			
小林正弥	名前-人名			
小林興起	名前-人名			
小林誠	名前-人名			
小林雅之	名前-人名			
小森まなみ	名前-人名			
小池栄子	名前-人名			
小沢なつき	名前-人名			
小野紀明	名前-人名			
尾崎紅葉	名前-人名			
山下達郎	名前-人名			
山口智子	名前-人名			
山口百恵	名前-人名			
山本耀司	名前-人名			
山本達彦	名前-人名			
山本麻里安	名前-人名			
山田太一	名前-人名			
岡崎優	名前-人名			
岡崎彰	名前-人名			
岡江久美子	名前-人名			
岡部達味	名前-人名			
岩井克人	名前-人名			
岩崎俊弥	名前-人名			
岩崎勝太郎	名前-人名			
岩崎宏美	名前-人名			
岩崎寛弥	名前-人名			
岩崎寿男	名前-人名			
岩崎小弥太	名前-人名			
岩崎彦弥太	名前-人名			
岩崎忠夫	名前-人名			
岩崎忠雄	名前-人名			
岩崎隆弥	名前-人名			
岩村俊哉	名前-人名			
岩瀬昌嗣	名前-人名			
岩田由貴	名前-人名			
岩隈久志	名前-人名			
嵯峨根遼吉	名前-人名			
川上とも子	名前-人名			
川島和津実	名前-人名			
川村龍夫	名前-人名			
川澄綾子	名前-人名			
川畑要	名前-人名			
市川由衣	名前-人名			
布施明	名前-人名			
平山信	名前-人名			
平松時庸	名前-人名			
平田広明	名前-人名			
弓場沙織	名前-人名			
後水尾天皇	名前-人名			
後藤リウ	名前-人名			
後藤次利	名前-人名			
後藤真希	名前-人名			
御厨貴	名前-人名			
忌野清志郎	名前-人名			
志村けん	名前-人名			
愛知和男	名前-人名			
戸田泰成	名前-人名			
折笠富美子	名前-人名			
持田香織	名前-人名			
斉藤哲夫	名前-人名			
新井素子	名前-人名			
新藤宗幸	名前-人名			
日高のり子	名前-人名			
星出彰彦	名前-人名			
星野順治	名前-人名			
曽我篤士	名前-人名			
朝比奈ゆい	名前-人名			
木下ともたけ	名前-人名			
木内信胤	名前-人名			
木戸幸一	名前-人名			
木村佳乃	名前-人名			
木村多江	名前-人名			
木村昴	名前-人名			
木梨憲武	名前-人名			
本仮屋ユイカ	名前-人名			
本間長世	名前-人名			
杉本甫	名前-人名			
杉本苑子	名前-人名			
村上としや	名前-人名			
村上泰亮	名前-人名			
村上綾歌	名前-人名			
村上陽一郎	名前-人名			
村上麗奈	名前-人名			
村山定男	名前-人名			
村松岐夫	名前-人名			
村田あゆみ	名前-人名			
東久邇宮稔彦王	名前-人名			
東富士欽壹	名前-人名			
東條英機	名前-人名			
東浩紀	名前-人名			
東海林さだお	名前-人名			
松下圭一	名前-人名			
松任谷由実	名前-人名			
松本伊代	名前-人名			
松本隆	名前-人名			
松浦まさふみ	名前-人名			
松野太紀	名前-人名			
林原めぐみ	名前-人名			
林譲治	名前-人名			
柴宜弘	名前-人名			
栃東大裕	名前-人名			
栃錦清隆	名前-人名			
栗本薫	名前-人名			
根食真実	名前-人名			
桃井はるこ	名前-人名			
桑谷夏子	名前-人名			
桑野信義	名前-人名			
桜内義雄	名前-人名			
桜樹ルイ	名前-人名			
梶芽衣子	名前-人名			
森且行	名前-人名			
森山直太朗	名前-人名			
森山良子	名前-人名			
森本哲郎	名前-人名			
森本毅郎	名前-人名			
森本雅樹	名前-人名			
森重樹一	名前-人名			
植田まさし	名前-人名			
椎名へきる	名前-人名			
椎名誠	名前-人名			
榊原英資	名前-人名			
榎本温子	名前-人名			
樋口一葉	名前-人名			
橋本大二郎	名前-人名			
橋本龍太郎	名前-人名			
檀ふみ	名前-人名			
武満徹	名前-人名			
水谷リカ	名前-人名			
永井荷風	名前-人名			
永井路子	名前-人名			
永井陽之助	名前-人名			
永田杏奈	名前-人名			
江利チエミ	名前-人名			
池井優	名前-人名			
池内恵	名前-人名			
池原しげと	名前-人名			
池波正太郎	名前-人名			
池田成	名前-人名			
沖一	名前-人名			
沢城みゆき	名前-人名			
沢田美喜	名前-人名			
河上丈太郎	名前-人名			
河原よしえ	名前-人名			
河辺千恵子	名前-人名			
沼尻沙弥香	名前-人名			
泉麻人	名前-人名			
浅井清己	名前-人名			
浅倉大介	名前-人名			
浅倉舞	名前-人名			
浅川悠	名前-人名			
浅沼稲次郎	名前-人名			
浅見れいな	名前-人名			
浅野まゆみ	名前-人名			
浦沢直樹	名前-人名			
浪川大輔	名前-人名			
深澤辰哉	名前-人名			
深田恭子	名前-人名			
清水信之	名前-人名			
清水圭	名前-人名			
清水愛	名前-人名			
渡辺満里奈	名前-人名			
渡辺雅男	名前-人名			
渡邉恒雄	名前-人名			
渥美清	名前-人名			
湯川秀樹	名前-人名			
源静香	名前-人名			
犬養健	名前-人名			
犬養道子	名前-人名			
狩野茉莉	名前-人名			
玉の海正洋	名前-人名			
玉ノ富士茂	名前-人名			
玉乃島新	名前-人名			
玉乃海太三郎	名前-人名			
玉力道栄来	名前-人名			
玉春日良二	名前-人名			
玉海力剛	名前-人名			
玉輝山正則	名前-人名			
玉飛鳥大輔	名前-人名			
玉龍大蔵	名前-人名			
瑛太	名前-人名			
田中真紀子	名前-人名			
田中裕二	名前-人名			
由貴香織里	名前-人名			
町山広美	名前-人名			
白石ひとみ	名前-人名			
皆川ゆか	名前-人名			
皆川博子	名前-人名			
相沢舞	名前-人名			
真崎春望	名前-人名			
矢作美樹	名前-人名			
石原さとみ	名前-人名			
石坂泰三	名前-人名			
石川よしひろ	名前-人名			
石橋湛山	名前-人名			
石橋貴明	名前-人名			
石田五郎	名前-人名			
破廉ケンチ	名前-人名			
礒部公一	名前-人名			
神代創	名前-人名			
神保彰	名前-人名			
神島二郎	名前-人名			
神田正宏	名前-人名			
神田武幸	名前-人名			
祭丘ヒデユキ	名前-人名			
福井晴敏	名前-人名			
福田和也	名前-人名			
福田己津央	名前-人名			
福田明日香	名前-人名			
秋本治	名前-人名			
稲垣吾郎	名前-人名			
稲葉正勝	名前-人名			
立川談志	名前-人名			
竜崎勝	名前-人名			
竹河聖	名前-人名			
箕作佳吉	名前-人名			
箕作元八	名前-人名			
箕作秋吉	名前-人名			
箕作麟祥	名前-人名			
紀平英作	名前-人名			
細川護熙	名前-人名			
細野晴臣	名前-人名			
結城恭介	名前-人名			
結城比呂	名前-人名			
緒方恵美	名前-人名			
緒方貞子	名前-人名			
美樹本晴彦	名前-人名			
美濃部亮吉	名前-人名			
美竹涼子	名前-人名			
羽田孜	名前-人名			
肝付兼太	名前-人名			
舘豊夫	名前-人名			
芝山努	名前-人名			
芥川也寸志	名前-人名			
芥川比呂志	名前-人名			
芥川龍之介	名前-人名			
若兎馬裕三	名前-人名			
茶谷やすら	名前-人名			
荒俣宏	名前-人名			
荒木経惟	名前-人名			
荻島正己	名前-人名			
菊池大麓	名前-人名			
菊池正士	名前-人名			
萩原一至	名前-人名			
蒼井そら	名前-人名			
蓮實重彦	名前-人名			
藤原帰一	名前-人名			
藤原彰	名前-人名			
藤子・F・不二雄	名前-人名			
藤尾正行	名前-人名			
西村博之	名前-人名			
西洞院時慶	名前-人名			
西洞院時直	名前-人名			
角野卓造	名前-人名			
角野栄子	名前-人名			
谷山浩子	名前-人名			
谷崎潤一郎	名前-人名			
谷崎精二	名前-人名			
貴乃花光司	名前-人名			
賀東招二	名前-人名			
赤津豊	名前-人名			
赤西仁	名前-人名			
越中睦	名前-人名			
越路吹雪	名前-人名			
車田正美	名前-人名			
辻希美	名前-人名			
辻香織	名前-人名			
近藤和久	名前-人名			
近衛文麿	名前-人名			
逢坂剛	名前-人名			
遠藤久美子	名前-人名			
遠藤明範	名前-人名			
那須野巧	名前-人名			
酒井順子	名前-人名			
釈由美子	名前-人名			
野呂一生	名前-人名			
野島健児	名前-人名			
野本憲一	名前-人名			
野比のび太	名前-人名			
金子修介	名前-人名			
金泰昌	名前-人名			
鈴木保奈美	名前-人名			
鈴木慶一	名前-人名			
鈴木祥子	名前-人名			
鈴木良武	名前-人名			
鈴木茂	名前-人名			
鈴木麻奈美	名前-人名			
長井秀和	名前-人名			
長塚京三	名前-人名			
長岡正男	名前-人名			
長沢工	名前-人名			
長澤真澄	名前-人名			
長谷川裕一	名前-人名			
長谷忠康	名前-人名			
門田博光	名前-人名			
門脇知子	名前-人名			
門脇舞	名前-人名			
関智一	名前-人名			
阪東妻三郎	名前-人名			
阿川佐和子	名前-人名			
隅澤克之	名前-人名			
雛形あきこ	名前-人名			
雪村いづみ	名前-人名			
須藤温子	名前-人名			
風野舞子	名前-人名			
飯塚雅弓	名前-人名			
飯島恋	名前-人名			
飯田恭平	名前-人名			
飯田馬之介	名前-人名			
香取慎吾	名前-人名			
香取秀真	名前-人名			
骨川スネ夫	名前-人名			
高山文彦	名前-人名			
高山瑞穂	名前-人名			
高島彩	名前-人名			
高島郷	名前-人名			
高村光太郎	名前-人名			
高村光雲	名前-人名			
高松信司	名前-人名			
高棟王	名前-人名			
高橋昌也	名前-人名			
高橋是清	名前-人名			
高畠通敏	名前-人名			
魁道康弘	名前-人名			
鮎川哲也	名前-人名			
鳥羽の山喜充	名前-人名			
鳩山一郎	名前-人名			
鳩山和夫	名前-人名			
鳩山由紀夫	名前-人名			
鴨武彦	名前-人名			
鶴見俊輔	名前-人名			
鷲巣力	名前-人名			
黒川芽以	名前-人名			
龍虎勢朋	名前-人名			
北澤晃男	名前-人名			
千葉智弘	名前-人名			
知久光康	名前-人名			
B Plus	名前-製品名-規則名			
カトー・カンブレジ条約	名前-製品名-規則名			
バイナリ転送プロトコル	名前-製品名-規則名			
学校教育法	名前-製品名-規則名			
専修学校設置基準	名前-製品名-規則名			
文部科学省令	名前-製品名-規則名			
社会保障法	名前-製品名-規則名			
セイレーン	名前-製品名-キャラクター名			
ドラミ	名前-製品名-キャラクター名			
剣道	名前-製品名-競技名			
合気道	名前-製品名-競技名			
麻雀	名前-製品名-競技名			
CASSHERN	名前-製品名-芸術名-映画名			
OVA	名前-製品名-芸術名-映画名			
THE有頂天ホテル	名前-製品名-芸術名-映画名			
みんなのいえ	名前-製品名-芸術名-映画名			
ゴジラ(1985)	名前-製品名-芸術名-映画名			
ゴジラ_(1984)	名前-製品名-芸術名-映画名			
マネーざんす	名前-製品名-芸術名-映画名			
君を忘れない	名前-製品名-芸術名-映画名			
嗤う伊右衛門	名前-製品名-芸術名-映画名			
学校	名前-製品名-芸術名-映画名			
新機動戦記ガンダムW Endless Waltz	名前-製品名-芸術名-映画名			
機動戦士Ζガンダム 星を継ぐ者	名前-製品名-芸術名-映画名			
機動戦士ガンダム MS IGLOO - 一年戦争秘録 -	名前-製品名-芸術名-映画名			
機動戦士ガンダム 逆襲のシャア	名前-製品名-芸術名-映画名			
機動戦士ガンダム0080 ポケットの中の戦争	名前-製品名-芸術名-映画名			
機動戦士ガンダム0083 STARDUST MEMORY	名前-製品名-芸術名-映画名			
機動戦士ガンダムF91	名前-製品名-芸術名-映画名			
機動戦士ガンダム第08MS小隊	名前-製品名-芸術名-映画名			
ミッション	名前-製品名-芸術名-映画名			
卒業	名前-製品名-芸術名-音楽名	名前-製品名-芸術名-映画名	名前-製品名-芸術名-番組名	名前-製品名-芸術名-文学名
妹よ	名前-製品名-芸術名-音楽名	名前-製品名-芸術名-番組名		
2ちゃんねる	名前-製品名-芸術名-芸術名_その他			
ラジオドラマ	名前-製品名-芸術名-番組名	固有名詞ではない		
この胸のときめきを	名前-製品名-芸術名-番組名	名前-製品名-芸術名-映画名	名前-製品名-芸術名-音楽名	
ガンダムシリーズ	名前-製品名-芸術名-番組名	名前-製品名-芸術名-映画名	名前-製品名-芸術名-芸術名_その他	名前-製品名-芸術名-文学名
機動戦士Ζガンダム	名前-製品名-芸術名-番組名	名前-製品名-芸術名-映画名		
新機動戦記ガンダムW BLIND TARGET	名前-製品名-芸術名-番組名	名前-製品名-芸術名-文学名		
機動戦士ガンダムSEED ASTRAY	名前-製品名-芸術名-番組名	名前-製品名-芸術名-文学名		
ガドガード	名前-製品名-芸術名-番組名			
10号誕生!仮面ライダー全員集合!!	名前-製品名-芸術名-番組名			
G-SAVIOUR	名前-製品名-芸術名-番組名			
GAD GUARD	名前-製品名-芸術名-番組名			
NHKニュース9	名前-製品名-芸術名-番組名			
∀ガンダム	名前-製品名-芸術名-番組名			
かんさいニュース1番	名前-製品名-芸術名-番組名			
はなまるマーケット	名前-製品名-芸術名-番組名			
アンドロメダストーリーズ	名前-製品名-芸術名-番組名			
オレたちひょうきん族	名前-製品名-芸術名-番組名			
ハチロー〜母の詩、父の詩〜	名前-製品名-芸術名-番組名			
ハロー張りネズミ	名前-製品名-芸術名-番組名			
ホームワーク	名前-製品名-芸術名-番組名			
世界遺産	名前-製品名-芸術名-番組名			
京都ニュース845	名前-製品名-芸術名-番組名			
利家とまつ 加賀百万石物語	名前-製品名-芸術名-番組名			
大戦隊ゴーグルファイブ	名前-製品名-芸術名-番組名			
大河ドラマ	名前-製品名-芸術名-番組名			
愛という名のもとに	名前-製品名-芸術名-番組名			
新機動戦記ガンダムW	名前-製品名-芸術名-番組名			
日曜劇場	名前-製品名-芸術名-番組名			
機動戦士Vガンダム	名前-製品名-芸術名-番組名			
機動戦士ガンダムSEED	名前-製品名-芸術名-番組名			
機動戦士ガンダムSEED DESTINY	名前-製品名-芸術名-番組名			
機動戦士ガンダムΖΖ	名前-製品名-芸術名-番組名			
機動新世紀ガンダムX	名前-製品名-芸術名-番組名			
機動武闘伝Gガンダム	名前-製品名-芸術名-番組名			
欽ちゃんのドンとやってみよう!	名前-製品名-芸術名-番組名			
純ちゃんの応援歌	名前-製品名-芸術名-番組名			
結婚の理想と現実	名前-製品名-芸術名-番組名			
輝け隣太郎	名前-製品名-芸術名-番組名			
トップスチュワーデス物語	名前-製品名-芸術名-番組名			
SF漫画	名前-製品名-芸術名-文学名	固有名詞ではない		
ゲームブック	名前-製品名-芸術名-文学名	固有名詞ではない		
青の炎	名前-製品名-芸術名-文学名	名前-製品名-芸術名-映画名		
カードキャプターさくら	名前-製品名-芸術名-文学名	名前-製品名-芸術名-番組名	名前-製品名-製品名_その他	
ガイア・ギア	名前-製品名-芸術名-文学名	名前-製品名-芸術名-番組名		
サイコドクター	名前-製品名-芸術名-文学名	名前-製品名-芸術名-番組名		
機動戦士ガンダム 閃光のハサウェイ	名前-製品名-芸術名-文学名			
∀ガンダム Episodes	名前-製品名-芸術名-文学名			
ガンダム・センチネル	名前-製品名-芸術名-文学名			
門	名前-製品名-芸術名-文学名			
ADVANCE OF Ζ ティターンズの旗のもとに	名前-製品名-芸術名-文学名			
MS戦記 機動戦士ガンダム0079外伝	名前-製品名-芸術名-文学名			
アウターガンダム	名前-製品名-芸術名-文学名			
エコール・デュ・シエル 天空の学校	名前-製品名-芸術名-文学名			
ガンダムパイロット列伝 蒼穹の勇者達	名前-製品名-芸術名-文学名			
宇宙のイシュタム	名前-製品名-芸術名-文学名			
新MS戦記 機動戦士ガンダム短編集	名前-製品名-芸術名-文学名			
新機動戦記ガンダムW BATTLEFIELD OF PACIFIST	名前-製品名-芸術名-文学名			
日出処の天子	名前-製品名-芸術名-文学名			
日本百名山	名前-製品名-芸術名-文学名			
機動戦士VS伝説巨神 逆襲のギガンティス	名前-製品名-芸術名-文学名			
機動戦士ガンダム C.D.A. 若き彗星の肖像	名前-製品名-芸術名-文学名			
機動戦士ガンダム MSジェネレーション	名前-製品名-芸術名-文学名			
機動戦士ガンダム THE ORIGIN	名前-製品名-芸術名-文学名			
機動戦士ガンダム シルエットフォーミュラ91	名前-製品名-芸術名-文学名			
機動戦士ガンダム ジオンの再興	名前-製品名-芸術名-文学名			
機動戦士ガンダム ムーンクライシス	名前-製品名-芸術名-文学名			
機動戦士ガンダムF90	名前-製品名-芸術名-文学名			
機動戦士ガンダムReon	名前-製品名-芸術名-文学名			
機動戦士ガンダムSEED DESTINY ASTRAY	名前-製品名-芸術名-文学名			
機動戦士ガンダム外伝 コロニーの落ちた地で	名前-製品名-芸術名-文学名			
機動新世紀ガンダムX〜UNDER THE MOONLIGHT〜	名前-製品名-芸術名-文学名			
講座行政学	名前-製品名-芸術名-文学名			
Developers 機動戦士ガンダム Before One Year War	名前-製品名-芸術名-文学名			
新機動戦記ガンダムW G-UNIT	名前-製品名-芸術名-文学名			
AV	名前-製品名-言語名	名前-組織名-企業名	名前-地名-GPE-市区町村名	
チベット・ミャンマー語派	名前-製品名-言語名			
彝俗語	名前-製品名-言語名			
彝語	名前-製品名-言語名			
逮捕・監禁罪	名前-製品名-罪名			
カトリック教	名前-製品名-宗教名			
精霊信仰	名前-製品名-宗教名			
カトリック主義	名前-製品名-主義思想名			
ジャイアニズム	名前-製品名-主義思想名			
エンジン	名前-製品名-出版物名-雑誌名	名前-製品名-芸術名-番組名		
携帯電話	名前-製品名-製品名_その他	固有名詞ではない		
アダルトゲーム	名前-製品名-製品名_その他	固有名詞ではない		
カードゲーム	名前-製品名-製品名_その他	固有名詞ではない		
コンピュータゲーム	名前-製品名-製品名_その他	固有名詞ではない		
音楽ゲーム	名前-製品名-製品名_その他	固有名詞ではない		
機動戦士ガンダム外伝 宇宙、閃光の果てに…	名前-製品名-製品名_その他	名前-製品名-芸術名-文学名		
機動戦士ガンダムF91 フォーミュラー戦記0122	名前-製品名-製品名_その他			
機動戦士クロスボーン・ガンダム	名前-製品名-製品名_その他			
1NZ-FE	名前-製品名-製品名_その他			
GOA	名前-製品名-製品名_その他			
LHA	名前-製品名-製品名_その他			
MS-DOS	名前-製品名-製品名_その他			
Macintosh	名前-製品名-製品名_その他			
Microsoft_Windows_Me	名前-製品名-製品名_その他			
NifTerm	名前-製品名-製品名_その他			
ZEONIC FRONT 機動戦士ガンダム0079	名前-製品名-製品名_その他			
カードダス	名前-製品名-製品名_その他			
カードワース	名前-製品名-製品名_その他			
ドラッグオンドラグーン	名前-製品名-製品名_その他			
ニフティマネージャー	名前-製品名-製品名_その他			
機動戦士ガンダム外伝 THE BLUE DESTINY	名前-製品名-製品名_その他			
機動戦士ガンダム戦記 Lost war chronicles	名前-製品名-製品名_その他			
秀Term	名前-製品名-製品名_その他			
簡易保険	名前-製品名-製品名_その他			
MOPTERM	名前-製品名-製品名_その他			
WTERM	名前-製品名-製品名_その他			
もしもボックス	名前-製品名-製品名_その他			
声のキャンデー	名前-製品名-製品名_その他			
菓子	名前-製品名-食べ物名	固有名詞ではない		
カード (食品)	名前-製品名-食べ物名			
ガトー・バスク	名前-製品名-食べ物名			
熱血飲料	名前-製品名-食べ物名			
AirCraft	名前-製品名-乗り物名-飛行機名			
潜水艦	名前-製品名-乗り物名-船名	固有名詞ではない		
駆逐艦	名前-製品名-乗り物名-船名	固有名詞ではない		
スームビング号	名前-製品名-乗り物名-船名			
フィリブス・ウニティス級戦艦	名前-製品名-乗り物名-船名			
多層建て列車	名前-製品名-乗り物名-列車名	固有名詞ではない		
普通列車	名前-製品名-乗り物名-列車名	固有名詞ではない		
特別急行列車	名前-製品名-乗り物名-列車名	固有名詞ではない		
新幹線	名前-製品名-乗り物名-列車名	名前-施設名-路線名-電車路線名		
なすの	名前-製品名-乗り物名-列車名			
エル特急	名前-製品名-乗り物名-列車名			
タンゴエクスプローラー	名前-製品名-乗り物名-列車名			
九州新幹線	名前-製品名-乗り物名-列車名			
九州横断特急	名前-製品名-乗り物名-列車名			
近鉄23000系電車	名前-製品名-乗り物名-列車名			
カノン	名前-製品名-武器名	名前-製品名-芸術名-文学名	?他に「カノン（歌手）」もあるが、個人かグループかわからない	
ガトリング砲	名前-製品名-武器名			
機雷	名前-製品名-武器名			
表音文字	名前-製品名-方式制度名	固有名詞ではない		
顔文字	名前-製品名-方式制度名			
アーベル群の基本定理	名前-製品名-理論名			
微分方程式	名前-製品名-理論名			
JR	名前-組織名-企業グループ名			
出版社	名前-組織名-企業名	固有名詞ではない		
@nifty	名前-組織名-企業名			
ComNifty	名前-組織名-企業名			
Vector	名前-組織名-企業名			
ほるぷ出版	名前-組織名-企業名			
イオンマルシェ	名前-組織名-企業名			
カドバリー	名前-組織名-企業名			
キャドバリー・シュウェップス	名前-組織名-企業名			
キープスマイリング	名前-組織名-企業名			
ソニーマガジンズ	名前-組織名-企業名			
ソニー・カルチャーエンタテインメント	名前-組織名-企業名			
プラス (企業)	名前-組織名-企業名			
加藤汽船	名前-組織名-企業名			
勁文社	名前-組織名-企業名			
北近畿タンゴ鉄道	名前-組織名-企業名			
千葉テレビ	名前-組織名-企業名			
大日本絵画	名前-組織名-企業名			
学陽書房	名前-組織名-企業名			
富士フイルム	名前-組織名-企業名			
岩波書店	名前-組織名-企業名			
徳間書店	名前-組織名-企業名			
有斐閣	名前-組織名-企業名			
朝日ソノラマ	名前-組織名-企業名			
東映アクションクラブ	名前-組織名-企業名			
研音	名前-組織名-企業名			
秋田書店	名前-組織名-企業名			
第一法規出版	名前-組織名-企業名			
茨城放送	名前-組織名-企業名			
NHK大阪放送局	名前-組織名-協会名			
NHK水戸放送局	名前-組織名-協会名			
WTA	名前-組織名-協会名			
放送大学教育振興会	名前-組織名-協会名			
日本郵政公社	名前-組織名-協会名			
東京大学出版会	名前-組織名-協会名			
NBA	名前-組織名-競技グループ名	名前-組織名-協会名		
Jリーグ	名前-組織名-競技グループ名			
ザスパ草津	名前-組織名-競技グループ名			
ジェフユナイテッド市原・千葉	名前-組織名-競技グループ名			
デポルティーボ・ラ・コルーニャ	名前-組織名-競技グループ名			
リーグ・アン	名前-組織名-競技グループ名			
押尾川部屋	名前-組織名-競技グループ名			
東北楽天ゴールデンイーグルス	名前-組織名-競技グループ名			
楽天ゴールデンイーグルス	名前-組織名-競技グループ名			
福岡ソフトバンクホークス	名前-組織名-競技グループ名			
海軍	名前-組織名-軍隊名	固有名詞ではない		
加藤隼戦闘隊	名前-組織名-軍隊名			
地方分権推進委員会	名前-組織名-政府組織名			
教育委員会	名前-組織名-政府組織名			
貴族院	名前-組織名-政府組織名			
警察署	名前-組織名-政府組織名			
エネルギー	名前-組織名-組織名_その他	単位名？		
プリズム	名前-組織名-組織名_その他	名前-製品名-芸術名-文学名	名前-製品名-芸術名-音楽名	
Y.M.O	名前-組織名-組織名_その他	名前-組織名-企業名		
ANTHEM	名前-組織名-組織名_その他			
C-C-B	名前-組織名-組織名_その他			
CHEMISTRY	名前-組織名-組織名_その他			
Field Of View	名前-組織名-組織名_その他			
JAYWALK	名前-組織名-組織名_その他			
JUN SKY WALKERS	名前-組織名-組織名_その他			
L'Arc-en-Ciel	名前-組織名-組織名_その他			
LADIES ROOM	名前-組織名-組織名_その他			
MALICE MIZER	名前-組織名-組織名_その他			
P-MODEL	名前-組織名-組織名_その他			
PENICILLIN	名前-組織名-組織名_その他			
RAG FAIR	名前-組織名-組織名_その他			
RCサクセション	名前-組織名-組織名_その他			
RYTHEM	名前-組織名-組織名_その他			
SHAZNA	名前-組織名-組織名_その他			
SMAP	名前-組織名-組織名_その他			
SOFT BALLET	名前-組織名-組織名_その他			
THE ALFEE	名前-組織名-組織名_その他			
THE YELLOW MONKEY	名前-組織名-組織名_その他			
TM NETWORK	名前-組織名-組織名_その他			
VOW WOW	名前-組織名-組織名_その他			
ZI:KILL	名前-組織名-組織名_その他			
ZIGGY	名前-組織名-組織名_その他			
ZIGZO	名前-組織名-組織名_その他			
Λucifer	名前-組織名-組織名_その他			
はっぴいえんど	名前-組織名-組織名_その他			
アメリカ合衆国統計局	名前-組織名-組織名_その他			
エレファントカシマシ	名前-組織名-組織名_その他			
ストリートスライダース	名前-組織名-組織名_その他			
トヨタビスタ店	名前-組織名-組織名_その他			
ネッツ店	名前-組織名-組織名_その他			
ブルーハーツ	名前-組織名-組織名_その他			
モーニング娘。	名前-組織名-組織名_その他			
リーガ・エスパニョーラ	名前-組織名-組織名_その他			
レッドウォーリアーズ	名前-組織名-組織名_その他			
中学部	名前-組織名-組織名_その他			
交野家	名前-組織名-組織名_その他			
保健医療学部	名前-組織名-組織名_その他			
医療福祉学部	名前-組織名-組織名_その他			
堂上家	名前-組織名-組織名_その他			
天真正伝香取神道流	名前-組織名-組織名_その他			
専攻科	名前-組織名-組織名_その他			
少林寺拳法	名前-組織名-組織名_その他			
平松家	名前-組織名-組織名_その他			
有頂天	名前-組織名-組織名_その他			
桓武平氏	名前-組織名-組織名_その他			
特撮	名前-組織名-組織名_その他			
看護学部	名前-組織名-組織名_その他			
聖飢魔II	名前-組織名-組織名_その他			
薬学部	名前-組織名-組織名_その他			
西洞院家	名前-組織名-組織名_その他			
香取神道流	名前-組織名-組織名_その他			
高等部	名前-組織名-組織名_その他			
FAIRY FORE	名前-組織名-組織名_その他			
GUS TANK	名前-組織名-組織名_その他			
群速度	名前-単位名-単位名_その他			
光年	名前-単位名-単位名_その他			
熊本藩	名前-地名-GPE-GPE_その他			
KEN	名前-地名-GPE-国名			
カトゥー郡	名前-地名-GPE-群名			
加東郡	名前-地名-GPE-群名			
北佐久郡	名前-地名-GPE-群名			
南魚沼郡	名前-地名-GPE-群名			
東彼杵郡	名前-地名-GPE-群名			
河東郡	名前-地名-GPE-群名			
益田郡	名前-地名-GPE-群名			
西松浦郡	名前-地名-GPE-群名			
西頸城郡	名前-地名-GPE-群名			
邇摩郡	名前-地名-GPE-群名			
邑智郡	名前-地名-GPE-群名			
阿武郡	名前-地名-GPE-群名			
香取郡	名前-地名-GPE-群名			
香美郡	名前-地名-GPE-群名			
上越市	名前-地名-GPE-市区町村名			
下呂市	名前-地名-GPE-市区町村名			
下呂町	名前-地名-GPE-市区町村名			
八幡西区	名前-地名-GPE-市区町村名			
八王子市	名前-地名-GPE-市区町村名			
北九州市	名前-地名-GPE-市区町村名			
北川村	名前-地名-GPE-市区町村名			
南国市	名前-地名-GPE-市区町村名			
呉市	名前-地名-GPE-市区町村名			
大和市	名前-地名-GPE-市区町村名			
大阪市	名前-地名-GPE-市区町村名			
奈半利町	名前-地名-GPE-市区町村名			
妙高市	名前-地名-GPE-市区町村名			
安芸市	名前-地名-GPE-市区町村名			
弥栄村	名前-地名-GPE-市区町村名			
有田町	名前-地名-GPE-市区町村名			
札幌市	名前-地名-GPE-市区町村名			
杉並区	名前-地名-GPE-市区町村名			
東広島市	名前-地名-GPE-市区町村名			
東御市	名前-地名-GPE-市区町村名			
東洋町	名前-地名-GPE-市区町村名			
江津市	名前-地名-GPE-市区町村名			
波佐見町	名前-地名-GPE-市区町村名			
浜田市	名前-地名-GPE-市区町村名			
湯沢町	名前-地名-GPE-市区町村名			
立川市	名前-地名-GPE-市区町村名			
糸魚川市	名前-地名-GPE-市区町村名			
芸西村	名前-地名-GPE-市区町村名			
若松区	名前-地名-GPE-市区町村名			
赤岡町	名前-地名-GPE-市区町村名			
野市町	名前-地名-GPE-市区町村名			
金城町	名前-地名-GPE-市区町村名			
門川町	名前-地名-GPE-市区町村名			
門真市	名前-地名-GPE-市区町村名			
阿武町	名前-地名-GPE-市区町村名			
青梅市	名前-地名-GPE-市区町村名			
香我美町	名前-地名-GPE-市区町村名			
馬瀬村	名前-地名-GPE-市区町村名			
高知市	名前-地名-GPE-市区町村名			
黒瀬町	名前-地名-GPE-市区町村名			
カトマンドゥ	名前-地名-GPE-都道府県州名			
ブリンディジ	名前-地名-GPE-都道府県州名			
リャンシャン・イ族自治州	名前-地名-GPE-都道府県州名			
北海道	名前-地名-GPE-都道府県州名			
カトゥチェ川	名前-地名-地形名-河川湖沼名			
濁河温泉	名前-地名-地形名-河川湖沼名			
下呂温泉	名前-地名-地形名-河川湖沼名			
カトマンズ盆地	名前-地名-地形名-陸上地形名			
名立谷浜インターチェンジ	名前-地名-地名_その他			
門真インターチェンジ	名前-地名-地名_その他			
球状星団	名前-地名-天体名-天体名_その他	固有名詞ではない		
メシエ天体	名前-地名-天体名-天体名_その他			
中世	時間表現-時間-時代表現			
永禄	時間表現-時間-時代表現			
11月	時間表現-時間-日付表現			
11月17日	時間表現-時間-日付表現			
1209年	時間表現-時間-日付表現			
12月27日	時間表現-時間-日付表現			
12月28日	時間表現-時間-日付表現			
12月5日	時間表現-時間-日付表現			
1491年	時間表現-時間-日付表現			
1557年	時間表現-時間-日付表現			
1561年	時間表現-時間-日付表現			
1848年	時間表現-時間-日付表現			
1871年	時間表現-時間-日付表現			
1878年	時間表現-時間-日付表現			
1894年	時間表現-時間-日付表現			
1897年	時間表現-時間-日付表現			
1901年	時間表現-時間-日付表現			
1903年	時間表現-時間-日付表現			
1904年	時間表現-時間-日付表現			
1905年	時間表現-時間-日付表現			
1907年	時間表現-時間-日付表現			
1909年	時間表現-時間-日付表現			
1913年	時間表現-時間-日付表現			
1915年	時間表現-時間-日付表現			
1918年	時間表現-時間-日付表現			
1924年	時間表現-時間-日付表現			
1926年	時間表現-時間-日付表現			
1930年	時間表現-時間-日付表現			
1936年	時間表現-時間-日付表現			
1939年	時間表現-時間-日付表現			
1942年	時間表現-時間-日付表現			
1943年	時間表現-時間-日付表現			
1945年	時間表現-時間-日付表現			
1952年	時間表現-時間-日付表現			
1957年	時間表現-時間-日付表現			
1962年	時間表現-時間-日付表現			
1966年	時間表現-時間-日付表現			
1971年	時間表現-時間-日付表現			
1973年	時間表現-時間-日付表現			
1987年	時間表現-時間-日付表現			
1990年代	時間表現-時間-日付表現			
19世紀	時間表現-時間-日付表現			
1月27日	時間表現-時間-日付表現			
2月10日	時間表現-時間-日付表現			
2月23日	時間表現-時間-日付表現			
3月10日	時間表現-時間-日付表現			
3月21日	時間表現-時間-日付表現			
3月27日	時間表現-時間-日付表現			
3月29日	時間表現-時間-日付表現			
3月31日	時間表現-時間-日付表現			
4月11日	時間表現-時間-日付表現			
5月30日	時間表現-時間-日付表現			
5月6日	時間表現-時間-日付表現			
6月10日	時間表現-時間-日付表現			
6月13日	時間表現-時間-日付表現			
6月5日	時間表現-時間-日付表現			
7月21日	時間表現-時間-日付表現			
7月3日	時間表現-時間-日付表現			
8月	時間表現-時間-日付表現			
8月31日	時間表現-時間-日付表現			
8月3日	時間表現-時間-日付表現			
9月22日	時間表現-時間-日付表現			
9月25日	時間表現-時間-日付表現			
9月2日	時間表現-時間-日付表現			
平成12年	時間表現-時間-日付表現			
平成16年	時間表現-時間-日付表現			
平成17年	時間表現-時間-日付表現			
平成22年	時間表現-時間-日付表現			
平成7年	時間表現-時間-日付表現			
昭和40年	時間表現-時間-日付表現			
大学生	数値表現-学齢			
融点	数値表現-寸法表現-温度			
沸点	数値表現-寸法表現-温度			
少子化	名前-イベント名-イベント名_その他			
少子高齢化	名前-イベント名-イベント名_その他			
阿波沖海戦	名前-イベント名-戦争名			
ロンドン海軍軍縮会議	名前-イベント名-催し物名-会議名			
K-1	名前-イベント名-催し物名-大会名			
国立天文台	名前-施設名-GOE-GOE_その他			
ゆめタウン	名前-施設名-GOE-GOE_その他			
ひばりが丘駅	名前-施設名-GOE-駅名-電車駅名			
二十四軒駅	名前-施設名-GOE-駅名-電車駅名			
二日市駅	名前-施設名-GOE-駅名-電車駅名			
和歌山市駅	名前-施設名-GOE-駅名-電車駅名			
和歌山駅	名前-施設名-GOE-駅名-電車駅名			
天拝山駅	名前-施設名-GOE-駅名-電車駅名			
天王寺駅	名前-施設名-GOE-駅名-電車駅名			
白浜駅	名前-施設名-GOE-駅名-電車駅名			
筑紫駅	名前-施設名-GOE-駅名-電車駅名			
紀伊富田駅	名前-施設名-GOE-駅名-電車駅名			
紀伊田辺駅	名前-施設名-GOE-駅名-電車駅名			
西武新宿駅	名前-施設名-GOE-駅名-電車駅名			
西鉄二日市駅	名前-施設名-GOE-駅名-電車駅名			
調布駅	名前-施設名-GOE-駅名-電車駅名			
難波駅	名前-施設名-GOE-駅名-電車駅名			
単科大学	名前-施設名-GOE-学校名	固有名詞ではない		
商業高等学校	名前-施設名-GOE-学校名	固有名詞ではない		
国立大学	名前-施設名-GOE-学校名	固有名詞ではない		
大学院大学	名前-施設名-GOE-学校名	固有名詞ではない		
工業高等学校	名前-施設名-GOE-学校名	固有名詞ではない		
新制大学	名前-施設名-GOE-学校名	固有名詞ではない		
理工系大学	名前-施設名-GOE-学校名	固有名詞ではない		
職業高校	名前-施設名-GOE-学校名	固有名詞ではない		
ゴンヴィル アンド キース・カレッジ	名前-施設名-GOE-学校名			
チャーチル・カレッジ	名前-施設名-GOE-学校名			
ニューナム・カレッジ	名前-施設名-GOE-学校名			
政策研究大学院大学	名前-施設名-GOE-学校名			
日本大学第二高等学校	名前-施設名-GOE-学校名			
総合研究大学院大学	名前-施設名-GOE-学校名			
伊和都比売神社	名前-施設名-GOE-神社寺名			
調神社	名前-施設名-GOE-神社寺名			
京王線	名前-施設名-路線名-電車路線名			
南海本線	名前-施設名-路線名-電車路線名			
札幌市営地下鉄東西線	名前-施設名-路線名-電車路線名			
東武越生線	名前-施設名-路線名-電車路線名			
松浦鉄道西九州線	名前-施設名-路線名-電車路線名			
西武新宿線	名前-施設名-路線名-電車路線名			
西鉄天神大牟田線	名前-施設名-路線名-電車路線名			
人見街道	名前-施設名-路線名-道路名			
北海道道3号札幌夕張線	名前-施設名-路線名-道路名			
国道188号	名前-施設名-路線名-道路名			
国道204号	名前-施設名-路線名-道路名			
国道20号	名前-施設名-路線名-道路名			
国道2号	名前-施設名-路線名-道路名			
国道3号	名前-施設名-路線名-道路名			
国道6号	名前-施設名-路線名-道路名			
大洲道路	名前-施設名-路線名-道路名			
州間高速道路5号線	名前-施設名-路線名-道路名			
東京都道14号新宿国立線	名前-施設名-路線名-道路名			
東京都道229号府中調布線	名前-施設名-路線名-道路名			
東京都道248号府中小平線	名前-施設名-路線名-道路名			
甲州街道	名前-施設名-路線名-道路名			
ボディー	名前-自然物名-生物名-動物部位名	固有名詞ではない		
目	名前-自然物名-生物名-動物部位名			
ヤツガシラ	名前-自然物名-生物名-動物名-脊椎動物-鳥類	名前-自然物名-生物名-植物名		
アオアシシギ	名前-自然物名-生物名-動物名-脊椎動物-鳥類			
アオカワラヒワ	名前-自然物名-生物名-動物名-脊椎動物-鳥類			
アオガラ	名前-自然物名-生物名-動物名-脊椎動物-鳥類			
アオガン	名前-自然物名-生物名-動物名-脊椎動物-鳥類			
アオシギ	名前-自然物名-生物名-動物名-脊椎動物-鳥類			
アオショウビン	名前-自然物名-生物名-動物名-脊椎動物-鳥類			
アオツラカツオドリ	名前-自然物名-生物名-動物名-脊椎動物-鳥類			
アオハシコウ	名前-自然物名-生物名-動物名-脊椎動物-鳥類			
アカアシカツオドリ	名前-自然物名-生物名-動物名-脊椎動物-鳥類			
アカアシシギ	名前-自然物名-生物名-動物名-脊椎動物-鳥類			
アカアシチョウゲンボウ	名前-自然物名-生物名-動物名-脊椎動物-鳥類			
アカアシミズナギドリ	名前-自然物名-生物名-動物名-脊椎動物-鳥類			
アカエリカイツブリ	名前-自然物名-生物名-動物名-脊椎動物-鳥類			
アカエリヒレアシシギ	名前-自然物名-生物名-動物名-脊椎動物-鳥類			
アカエリヨタカ	名前-自然物名-生物名-動物名-脊椎動物-鳥類			
アカオイワビタキ	名前-自然物名-生物名-動物名-脊椎動物-鳥類			
アカオタテガモ	名前-自然物名-生物名-動物名-脊椎動物-鳥類			
アカオモズ	名前-自然物名-生物名-動物名-脊椎動物-鳥類			
アカガシラチョウゲンボウ	名前-自然物名-生物名-動物名-脊椎動物-鳥類			
アカゲラ	名前-自然物名-生物名-動物名-脊椎動物-鳥類			
アカツクシガモ	名前-自然物名-生物名-動物名-脊椎動物-鳥類			
アカトビ	名前-自然物名-生物名-動物名-脊椎動物-鳥類			
アカハシオナガガモ	名前-自然物名-生物名-動物名-脊椎動物-鳥類			
アカハシカモメ	名前-自然物名-生物名-動物名-脊椎動物-鳥類			
アカハシコガモ	名前-自然物名-生物名-動物名-脊椎動物-鳥類			
アカハシネッタイチョウ	名前-自然物名-生物名-動物名-脊椎動物-鳥類			
アカハシハジロ	名前-自然物名-生物名-動物名-脊椎動物-鳥類			
アカマシコ	名前-自然物名-生物名-動物名-脊椎動物-鳥類			
アカメジュズカケバト	名前-自然物名-生物名-動物名-脊椎動物-鳥類			
アカリュウキュウガモ	名前-自然物名-生物名-動物名-脊椎動物-鳥類			
アシナガウミツバメ	名前-自然物名-生物名-動物名-脊椎動物-鳥類			
アシナガワシ	名前-自然物名-生物名-動物名-脊椎動物-鳥類			
アジアコヒバリ	名前-自然物名-生物名-動物名-脊椎動物-鳥類			
アジアサバクスズメ	名前-自然物名-生物名-動物名-脊椎動物-鳥類			
アジアヘビウ	名前-自然物名-生物名-動物名-脊椎動物-鳥類			
アジサシ	名前-自然物名-生物名-動物名-脊椎動物-鳥類			
アトリ	名前-自然物名-生物名-動物名-脊椎動物-鳥類			
アネハヅル	名前-自然物名-生物名-動物名-脊椎動物-鳥類			
アビ	名前-自然物名-生物名-動物名-脊椎動物-鳥類			
アビシニアヨタカ	名前-自然物名-生物名-動物名-脊椎動物-鳥類			
アフガンムシクイ	名前-自然物名-生物名-動物名-脊椎動物-鳥類			
アフリカオオバン	名前-自然物名-生物名-動物名-脊椎動物-鳥類			
アフリカギンバシ	名前-自然物名-生物名-動物名-脊椎動物-鳥類			
アフリカクロサギ	名前-自然物名-生物名-動物名-脊椎動物-鳥類			
アフリカクロトキ	名前-自然物名-生物名-動物名-脊椎動物-鳥類			
アフリカコシジロアマツバメ	名前-自然物名-生物名-動物名-脊椎動物-鳥類			
アフリカコノハズク	名前-自然物名-生物名-動物名-脊椎動物-鳥類			
アフリカコビトウ	名前-自然物名-生物名-動物名-脊椎動物-鳥類			
アフリカコミミズク	名前-自然物名-生物名-動物名-脊椎動物-鳥類			
アフリカサンコウチョウ	名前-自然物名-生物名-動物名-脊椎動物-鳥類			
アフリカソウゲンワシ	名前-自然物名-生物名-動物名-脊椎動物-鳥類			
アフリカチャイロツバメ	名前-自然物名-生物名-動物名-脊椎動物-鳥類			
アフリカツバメトビ	名前-自然物名-生物名-動物名-脊椎動物-鳥類			
アフリカトキコウ	名前-自然物名-生物名-動物名-脊椎動物-鳥類			
アフリカハゲコウ	名前-自然物名-生物名-動物名-脊椎動物-鳥類			
アフリカハサミアジサシ	名前-自然物名-生物名-動物名-脊椎動物-鳥類			
アフリカヒメコウテンシ	名前-自然物名-生物名-動物名-脊椎動物-鳥類			
アフリカヒヨドリ	名前-自然物名-生物名-動物名-脊椎動物-鳥類			
アフリカヘビウ	名前-自然物名-生物名-動物名-脊椎動物-鳥類			
アフリカヘラサギ	名前-自然物名-生物名-動物名-脊椎動物-鳥類			
アフリカマミジロタヒバリ	名前-自然物名-生物名-動物名-脊椎動物-鳥類			
アフリカムナフヒタキ	名前-自然物名-生物名-動物名-脊椎動物-鳥類			
アフリカムラサキバン	名前-自然物名-生物名-動物名-脊椎動物-鳥類			
アフリカヤブヒバリ	名前-自然物名-生物名-動物名-脊椎動物-鳥類			
アフリカヨシキリ	名前-自然物名-生物名-動物名-脊椎動物-鳥類			
アフリカワシミミズク	名前-自然物名-生物名-動物名-脊椎動物-鳥類			
アマサギ	名前-自然物名-生物名-動物名-脊椎動物-鳥類			
アメリカイソシギ	名前-自然物名-生物名-動物名-脊椎動物-鳥類			
アメリカウズラシギ	名前-自然物名-生物名-動物名-脊椎動物-鳥類			
アメリカオオアジサシ	名前-自然物名-生物名-動物名-脊椎動物-鳥類			
アメリカグンカンドリ	名前-自然物名-生物名-動物名-脊椎動物-鳥類			
アメリカヒレアシシギ	名前-自然物名-生物名-動物名-脊椎動物-鳥類			
アメリカムナグロ	名前-自然物名-生物名-動物名-脊椎動物-鳥類			
アメリカムラサキバン	名前-自然物名-生物名-動物名-脊椎動物-鳥類			
アラビアアカゲラ	名前-自然物名-生物名-動物名-脊椎動物-鳥類			
アラビアアジサシ	名前-自然物名-生物名-動物名-脊椎動物-鳥類			
アラビアアナドリ	名前-自然物名-生物名-動物名-脊椎動物-鳥類			
アラビアイワシャコ	名前-自然物名-生物名-動物名-脊椎動物-鳥類			
アラビアイワヒバリ	名前-自然物名-生物名-動物名-脊椎動物-鳥類			
アラビアウタムシクイ	名前-自然物名-生物名-動物名-脊椎動物-鳥類			
アラビアオオノガン	名前-自然物名-生物名-動物名-脊椎動物-鳥類			
アラビアオリーブツグミ	名前-自然物名-生物名-動物名-脊椎動物-鳥類			
アラビアカエデチョウ	名前-自然物名-生物名-動物名-脊椎動物-鳥類			
アラビアカナリア	名前-自然物名-生物名-動物名-脊椎動物-鳥類			
アラビアカラムシクイ	名前-自然物名-生物名-動物名-脊椎動物-鳥類			
アラビアコアジサシ	名前-自然物名-生物名-動物名-脊椎動物-鳥類			
アラビアコガネスズメ	名前-自然物名-生物名-動物名-脊椎動物-鳥類			
アラビアサバクヒタキ	名前-自然物名-生物名-動物名-脊椎動物-鳥類			
アラビアテリムク	名前-自然物名-生物名-動物名-脊椎動物-鳥類			
アラビアヒヨドリ	名前-自然物名-生物名-動物名-脊椎動物-鳥類			
アラビアヤブチメドリ	名前-自然物名-生物名-動物名-脊椎動物-鳥類			
アリスイ	名前-自然物名-生物名-動物名-脊椎動物-鳥類			
アルタイコノドジロムシクイ	名前-自然物名-生物名-動物名-脊椎動物-鳥類			
アルメニアセグロカモメ	名前-自然物名-生物名-動物名-脊椎動物-鳥類			
アレチウタムシクイ	名前-自然物名-生物名-動物名-脊椎動物-鳥類			
イエガラス	名前-自然物名-生物名-動物名-脊椎動物-鳥類			
イエスズメ	名前-自然物名-生物名-動物名-脊椎動物-鳥類			
イエホオジロ	名前-自然物名-生物名-動物名-脊椎動物-鳥類			
イエメンヒワ	名前-自然物名-生物名-動物名-脊椎動物-鳥類			
イシチドリ	名前-自然物名-生物名-動物名-脊椎動物-鳥類			
イスカ	名前-自然物名-生物名-動物名-脊椎動物-鳥類			
イソシギ	名前-自然物名-生物名-動物名-脊椎動物-鳥類			
イソヒヨドリ	名前-自然物名-生物名-動物名-脊椎動物-鳥類			
イナダヨシキリ	名前-自然物名-生物名-動物名-脊椎動物-鳥類			
イナバヒタキ	名前-自然物名-生物名-動物名-脊椎動物-鳥類			
イラクヤブチメドリ	名前-自然物名-生物名-動物名-脊椎動物-鳥類			
イランサバクガラス	名前-自然物名-生物名-動物名-脊椎動物-鳥類			
イランムシクイ	名前-自然物名-生物名-動物名-脊椎動物-鳥類			
イワゴジュウカラ	名前-自然物名-生物名-動物名-脊椎動物-鳥類			
イワシャコ	名前-自然物名-生物名-動物名-脊椎動物-鳥類			
イワスズメ	名前-自然物名-生物名-動物名-脊椎動物-鳥類			
イワツバメ	名前-自然物名-生物名-動物名-脊椎動物-鳥類			
イワバホオジロ	名前-自然物名-生物名-動物名-脊椎動物-鳥類			
イワヒバリ	名前-自然物名-生物名-動物名-脊椎動物-鳥類			
イワミセキレイ	名前-自然物名-生物名-動物名-脊椎動物-鳥類			
インダススズメ	名前-自然物名-生物名-動物名-脊椎動物-鳥類			
インドアカガシラサギ	名前-自然物名-生物名-動物名-脊椎動物-鳥類			
インドオオコノハズク	名前-自然物名-生物名-動物名-脊椎動物-鳥類			
インドコキンメフクロウ	名前-自然物名-生物名-動物名-脊椎動物-鳥類			
インドコヒバリ	名前-自然物名-生物名-動物名-脊椎動物-鳥類			
インドトサカゲリ	名前-自然物名-生物名-動物名-脊椎動物-鳥類			
インドハッカ	名前-自然物名-生物名-動物名-脊椎動物-鳥類			
インドヒメクロアジサシ	名前-自然物名-生物名-動物名-脊椎動物-鳥類			
インドブッポウソウ	名前-自然物名-生物名-動物名-脊椎動物-鳥類			
インドヨタカ	名前-自然物名-生物名-動物名-脊椎動物-鳥類			
ウスアマツバメ	名前-自然物名-生物名-動物名-脊椎動物-鳥類			
ウスイロイワスズメ	名前-自然物名-生物名-動物名-脊椎動物-鳥類			
ウスイロハマヒバリ	名前-自然物名-生物名-動物名-脊椎動物-鳥類			
ウスイロモリフクロウ	名前-自然物名-生物名-動物名-脊椎動物-鳥類			
ウスイロヨタカ	名前-自然物名-生物名-動物名-脊椎動物-鳥類			
ウスズミハヤブサ	名前-自然物名-生物名-動物名-脊椎動物-鳥類			
ウスチャイロツバメ	名前-自然物名-生物名-動物名-脊椎動物-鳥類			
ウスハイイロチュウヒ	名前-自然物名-生物名-動物名-脊椎動物-鳥類			
ウスユキガモ	名前-自然物名-生物名-動物名-脊椎動物-鳥類			
ウズラクイナ	名前-自然物名-生物名-動物名-脊椎動物-鳥類			
ウズラシギ	名前-自然物名-生物名-動物名-脊椎動物-鳥類			
ウソ	名前-自然物名-生物名-動物名-脊椎動物-鳥類			
ウタイムシクイ	名前-自然物名-生物名-動物名-脊椎動物-鳥類			
ウタオオタカ	名前-自然物名-生物名-動物名-脊椎動物-鳥類			
ウタツグミ	名前-自然物名-生物名-動物名-脊椎動物-鳥類			
ウミアイサ	名前-自然物名-生物名-動物名-脊椎動物-鳥類			
ウロコスナヒバリ	名前-自然物名-生物名-動物名-脊椎動物-鳥類			
エジプトガン	名前-自然物名-生物名-動物名-脊椎動物-鳥類			
エジプトタイヨウチョウ	名前-自然物名-生物名-動物名-脊椎動物-鳥類			
エジプトハゲワシ	名前-自然物名-生物名-動物名-脊椎動物-鳥類			
エジプトヨタカ	名前-自然物名-生物名-動物名-脊椎動物-鳥類			
エチオピアノドジロツバメ	名前-自然物名-生物名-動物名-脊椎動物-鳥類			
エナガ	名前-自然物名-生物名-動物名-脊椎動物-鳥類			
エリグロアジサシ	名前-自然物名-生物名-動物名-脊椎動物-鳥類			
エリマキシギ	名前-自然物名-生物名-動物名-脊椎動物-鳥類			
エレオノラハヤブサ	名前-自然物名-生物名-動物名-脊椎動物-鳥類			
エンビコウ	名前-自然物名-生物名-動物名-脊椎動物-鳥類			
オウチュウ	名前-自然物名-生物名-動物名-脊椎動物-鳥類			
オオアカゲラ	名前-自然物名-生物名-動物名-脊椎動物-鳥類			
オオアジサシ	名前-自然物名-生物名-動物名-脊椎動物-鳥類			
オオカモメ	名前-自然物名-生物名-動物名-脊椎動物-鳥類			
オオジュリン	名前-自然物名-生物名-動物名-脊椎動物-鳥類			
オオズグロカモメ	名前-自然物名-生物名-動物名-脊椎動物-鳥類			
オオソリハシシギ	名前-自然物名-生物名-動物名-脊椎動物-鳥類			
オオトウゾクカモメ	名前-自然物名-生物名-動物名-脊椎動物-鳥類			
オオノスリ	名前-自然物名-生物名-動物名-脊椎動物-鳥類			
オオハクチョウ	名前-自然物名-生物名-動物名-脊椎動物-鳥類			
オオハシシギ	名前-自然物名-生物名-動物名-脊椎動物-鳥類			
オオハム	名前-自然物名-生物名-動物名-脊椎動物-鳥類			
オオバン	名前-自然物名-生物名-動物名-脊椎動物-鳥類			
オオフラミンゴ	名前-自然物名-生物名-動物名-脊椎動物-鳥類			
オオホンセイインコ	名前-自然物名-生物名-動物名-脊椎動物-鳥類			
オオマスカリンミズナギドリ	名前-自然物名-生物名-動物名-脊椎動物-鳥類			
オオミズナギドリ	名前-自然物名-生物名-動物名-脊椎動物-鳥類			
オオメダイチドリ	名前-自然物名-生物名-動物名-脊椎動物-鳥類			
オオモズ	名前-自然物名-生物名-動物名-脊椎動物-鳥類			
オオヨシキリ	名前-自然物名-生物名-動物名-脊椎動物-鳥類			
オオルリ	名前-自然物名-生物名-動物名-脊椎動物-鳥類			
オカヨシガモ	名前-自然物名-生物名-動物名-脊椎動物-鳥類			
オガワコマドリ	名前-自然物名-生物名-動物名-脊椎動物-鳥類			
オグロシギ	名前-自然物名-生物名-動物名-脊椎動物-鳥類			
オグロムシクイ	名前-自然物名-生物名-動物名-脊椎動物-鳥類			
オジロゲリ	名前-自然物名-生物名-動物名-脊椎動物-鳥類			
オジロトウネン	名前-自然物名-生物名-動物名-脊椎動物-鳥類			
オジロビタキ	名前-自然物名-生物名-動物名-脊椎動物-鳥類			
オタテヤブコマドリ	名前-自然物名-生物名-動物名-脊椎動物-鳥類			
オナガガモ	名前-自然物名-生物名-動物名-脊椎動物-鳥類			
オナガニシブッポウソウ	名前-自然物名-生物名-動物名-脊椎動物-鳥類			
オナガミズナギドリ	名前-自然物名-生物名-動物名-脊椎動物-鳥類			
オナガムシクイ	名前-自然物名-生物名-動物名-脊椎動物-鳥類			
オニアオサギ	名前-自然物名-生物名-動物名-脊椎動物-鳥類			
オニアジサシ	名前-自然物名-生物名-動物名-脊椎動物-鳥類			
オニカッコウ	名前-自然物名-生物名-動物名-脊椎動物-鳥類			
オニミズナギドリ	名前-自然物名-生物名-動物名-脊椎動物-鳥類			
オバシギ	名前-自然物名-生物名-動物名-脊椎動物-鳥類			
オリーブウタムシクイ	名前-自然物名-生物名-動物名-脊椎動物-鳥類			
オリーブカナリア	名前-自然物名-生物名-動物名-脊椎動物-鳥類			
オリーブバト	名前-自然物名-生物名-動物名-脊椎動物-鳥類			
オリーブムシクイ	名前-自然物名-生物名-動物名-脊椎動物-鳥類			
カイツブリ	名前-自然物名-生物名-動物名-脊椎動物-鳥類			
カオグロサバクヒタキ	名前-自然物名-生物名-動物名-脊椎動物-鳥類			
カオジロアカゲラ	名前-自然物名-生物名-動物名-脊椎動物-鳥類			
カオジロウミツバメ	名前-自然物名-生物名-動物名-脊椎動物-鳥類			
カオジロオタテガモ	名前-自然物名-生物名-動物名-脊椎動物-鳥類			
カオジロガン	名前-自然物名-生物名-動物名-脊椎動物-鳥類			
カオジロミズナギドリ	名前-自然物名-生物名-動物名-脊椎動物-鳥類			
カケス	名前-自然物名-生物名-動物名-脊椎動物-鳥類			
カシラダカ	名前-自然物名-生物名-動物名-脊椎動物-鳥類			
カスピアコガラ	名前-自然物名-生物名-動物名-脊椎動物-鳥類			
カスピアセッケイ	名前-自然物名-生物名-動物名-脊椎動物-鳥類			
カタグロツバメゲリ	名前-自然物名-生物名-動物名-脊椎動物-鳥類			
カタグロトビ	名前-自然物名-生物名-動物名-脊椎動物-鳥類			
カタジロアカゲラ	名前-自然物名-生物名-動物名-脊椎動物-鳥類			
カタジロワシ	名前-自然物名-生物名-動物名-脊椎動物-鳥類			
カツオドリ	名前-自然物名-生物名-動物名-脊椎動物-鳥類			
カニチドリ	名前-自然物名-生物名-動物名-脊椎動物-鳥類			
カベバシリ	名前-自然物名-生物名-動物名-脊椎動物-鳥類			
カラフトムシクイ	名前-自然物名-生物名-動物名-脊椎動物-鳥類			
カラフトムジセッカ	名前-自然物名-生物名-動物名-脊椎動物-鳥類			
カラフトワシ	名前-自然物名-生物名-動物名-脊椎動物-鳥類			
カリガネ	名前-自然物名-生物名-動物名-脊椎動物-鳥類			
カワアイサ	名前-自然物名-生物名-動物名-脊椎動物-鳥類			
カワセンニュウ	名前-自然物名-生物名-動物名-脊椎動物-鳥類			
カワラバト	名前-自然物名-生物名-動物名-脊椎動物-鳥類			
カワリウタオオタカ	名前-自然物名-生物名-動物名-脊椎動物-鳥類			
カワリサバクヒタキ	名前-自然物名-生物名-動物名-脊椎動物-鳥類			
カンムリカイツブリ	名前-自然物名-生物名-動物名-脊椎動物-鳥類			
カンムリカワセミ	名前-自然物名-生物名-動物名-脊椎動物-鳥類			
カンムリガラ	名前-自然物名-生物名-動物名-脊椎動物-鳥類			
カンムリキジ	名前-自然物名-生物名-動物名-脊椎動物-鳥類			
カンムリサギ	名前-自然物名-生物名-動物名-脊椎動物-鳥類			
カンムリヒバリ	名前-自然物名-生物名-動物名-脊椎動物-鳥類			
キアオジ	名前-自然物名-生物名-動物名-脊椎動物-鳥類			
キアシセグロカモメ	名前-自然物名-生物名-動物名-脊椎動物-鳥類			
キイロウタムシクイ	名前-自然物名-生物名-動物名-脊椎動物-鳥類			
キイロハタオリ	名前-自然物名-生物名-動物名-脊椎動物-鳥類			
キガシラウミワシ	名前-自然物名-生物名-動物名-脊椎動物-鳥類			
キガシラセキレイ	名前-自然物名-生物名-動物名-脊椎動物-鳥類			
キクイタダキ	名前-自然物名-生物名-動物名-脊椎動物-鳥類			
キジバト	名前-自然物名-生物名-動物名-脊椎動物-鳥類			
キセキレイ	名前-自然物名-生物名-動物名-脊椎動物-鳥類			
キタアフリカワシミミズク	名前-自然物名-生物名-動物名-脊椎動物-鳥類			
キタキフサタイヨウチョウ	名前-自然物名-生物名-動物名-脊椎動物-鳥類			
キタヤナギムシクイ	名前-自然物名-生物名-動物名-脊椎動物-鳥類			
キノドアオジ	名前-自然物名-生物名-動物名-脊椎動物-鳥類			
キバシガラス	名前-自然物名-生物名-動物名-脊椎動物-鳥類			
キバシトビ	名前-自然物名-生物名-動物名-脊椎動物-鳥類			
キバシヒワ	名前-自然物名-生物名-動物名-脊椎動物-鳥類			
キバシリ	名前-自然物名-生物名-動物名-脊椎動物-鳥類			
キバラアオバト	名前-自然物名-生物名-動物名-脊椎動物-鳥類			
キプロスサバクヒタキ	名前-自然物名-生物名-動物名-脊椎動物-鳥類			
キプロスムシクイ	名前-自然物名-生物名-動物名-脊椎動物-鳥類			
キマユムシクイ	名前-自然物名-生物名-動物名-脊椎動物-鳥類			
キョウジョシギ	名前-自然物名-生物名-動物名-脊椎動物-鳥類			
キョクアジサシ	名前-自然物名-生物名-動物名-脊椎動物-鳥類			
キリアイ	名前-自然物名-生物名-動物名-脊椎動物-鳥類			
キレンジャク	名前-自然物名-生物名-動物名-脊椎動物-鳥類			
キンクロハジロ	名前-自然物名-生物名-動物名-脊椎動物-鳥類			
キンバネマシコ	名前-自然物名-生物名-動物名-脊椎動物-鳥類			
キンメフクロウ	名前-自然物名-生物名-動物名-脊椎動物-鳥類			
ギンバシ	名前-自然物名-生物名-動物名-脊椎動物-鳥類			
クイナ	名前-自然物名-生物名-動物名-脊椎動物-鳥類			
クサシギ	名前-自然物名-生物名-動物名-脊椎動物-鳥類			
クビワカモメ	名前-自然物名-生物名-動物名-脊椎動物-鳥類			
クビワコウテンシ	名前-自然物名-生物名-動物名-脊椎動物-鳥類			
クビワツグミ	名前-自然物名-生物名-動物名-脊椎動物-鳥類			
クマゲラ	名前-自然物名-生物名-動物名-脊椎動物-鳥類			
クロアジサシ	名前-自然物名-生物名-動物名-脊椎動物-鳥類			
クロウタドリ	名前-自然物名-生物名-動物名-脊椎動物-鳥類			
クロエリキジバト	名前-自然物名-生物名-動物名-脊椎動物-鳥類			
クロエリコウテンシ	名前-自然物名-生物名-動物名-脊椎動物-鳥類			
クロオウチュウ	名前-自然物名-生物名-動物名-脊椎動物-鳥類			
クロオビスナヒバリ	名前-自然物名-生物名-動物名-脊椎動物-鳥類			
クロガシラムシクイ	名前-自然物名-生物名-動物名-脊椎動物-鳥類			
クロガモ	名前-自然物名-生物名-動物名-脊椎動物-鳥類			
クロコウテンシ	名前-自然物名-生物名-動物名-脊椎動物-鳥類			
クロコサギ	名前-自然物名-生物名-動物名-脊椎動物-鳥類			
クロコシジロウミツバメ	名前-自然物名-生物名-動物名-脊椎動物-鳥類			
クロサバクヒタキ	名前-自然物名-生物名-動物名-脊椎動物-鳥類			
クロシロカンムリカッコウ	名前-自然物名-生物名-動物名-脊椎動物-鳥類			
クロジョウビタキ	名前-自然物名-生物名-動物名-脊椎動物-鳥類			
クロヅル	名前-自然物名-生物名-動物名-脊椎動物-鳥類			
クロトウゾクカモメ	名前-自然物名-生物名-動物名-脊椎動物-鳥類			
クロノビタキ	名前-自然物名-生物名-動物名-脊椎動物-鳥類			
クロハゲワシ	名前-自然物名-生物名-動物名-脊椎動物-鳥類			
クロハラアジサシ	名前-自然物名-生物名-動物名-脊椎動物-鳥類			
クロハラウミツバメ	名前-自然物名-生物名-動物名-脊椎動物-鳥類			
クロハラサケイ	名前-自然物名-生物名-動物名-脊椎動物-鳥類			
クロビタイサケイ	名前-自然物名-生物名-動物名-脊椎動物-鳥類			
クロビタイセアカモズ	名前-自然物名-生物名-動物名-脊椎動物-鳥類			
クロヤブコマ	名前-自然物名-生物名-動物名-脊椎動物-鳥類			
クロライチョウ	名前-自然物名-生物名-動物名-脊椎動物-鳥類			
ケアシノスリ	名前-自然物名-生物名-動物名-脊椎動物-鳥類			
ケープイシチドリ	名前-自然物名-生物名-動物名-脊椎動物-鳥類			
ケープベルデミズナギドリ	名前-自然物名-生物名-動物名-脊椎動物-鳥類			
コアオアシシギ	名前-自然物名-生物名-動物名-脊椎動物-鳥類			
コアカゲラ	名前-自然物名-生物名-動物名-脊椎動物-鳥類			
コアジサシ	名前-自然物名-生物名-動物名-脊椎動物-鳥類			
コイシチドリ	名前-自然物名-生物名-動物名-脊椎動物-鳥類			
コイソヒヨ	名前-自然物名-生物名-動物名-脊椎動物-鳥類			
コイワスズメ	名前-自然物名-生物名-動物名-脊椎動物-鳥類			
コウラウン	名前-自然物名-生物名-動物名-脊椎動物-鳥類			
コオバシギ	名前-自然物名-生物名-動物名-脊椎動物-鳥類			
コオリガモ	名前-自然物名-生物名-動物名-脊椎動物-鳥類			
コガネスズメ	名前-自然物名-生物名-動物名-脊椎動物-鳥類			
コガモ	名前-自然物名-生物名-動物名-脊椎動物-鳥類			
コキアシシギ	名前-自然物名-生物名-動物名-脊椎動物-鳥類			
コキジバト	名前-自然物名-生物名-動物名-脊椎動物-鳥類			
コキンメフクロウ	名前-自然物名-生物名-動物名-脊椎動物-鳥類			
コクイナ	名前-自然物名-生物名-動物名-脊椎動物-鳥類			
コクガン	名前-自然物名-生物名-動物名-脊椎動物-鳥類			
コグンカンドリ	名前-自然物名-生物名-動物名-脊椎動物-鳥類			
コザクラバシガン	名前-自然物名-生物名-動物名-脊椎動物-鳥類			
コシアカサバクヒタキ	名前-自然物名-生物名-動物名-脊椎動物-鳥類			
コシアカツバメ	名前-自然物名-生物名-動物名-脊椎動物-鳥類			
コシギ	名前-自然物名-生物名-動物名-脊椎動物-鳥類			
コシジロイソヒヨドリ	名前-自然物名-生物名-動物名-脊椎動物-鳥類			
コシジロイヌワシ	名前-自然物名-生物名-動物名-脊椎動物-鳥類			
コシジロウミツバメ	名前-自然物名-生物名-動物名-脊椎動物-鳥類			
コシジロサバクヒタキ	名前-自然物名-生物名-動物名-脊椎動物-鳥類			
コシベニペリカン	名前-自然物名-生物名-動物名-脊椎動物-鳥類			
コズアカコシアカツバメ	名前-自然物名-生物名-動物名-脊椎動物-鳥類			
コチドリ	名前-自然物名-生物名-動物名-脊椎動物-鳥類			
コチョウゲンボウ	名前-自然物名-生物名-動物名-脊椎動物-鳥類			
コノドジロムシクイ	名前-自然物名-生物名-動物名-脊椎動物-鳥類			
コノハズク	名前-自然物名-生物名-動物名-脊椎動物-鳥類			
コハッコウチョウ	名前-自然物名-生物名-動物名-脊椎動物-鳥類			
コバシカンムリヒバリ	名前-自然物名-生物名-動物名-脊椎動物-鳥類			
コバシチドリ	名前-自然物名-生物名-動物名-脊椎動物-鳥類			
コヒバリ	名前-自然物名-生物名-動物名-脊椎動物-鳥類			
コビトウ	名前-自然物名-生物名-動物名-脊椎動物-鳥類			
コフラミンゴ	名前-自然物名-生物名-動物名-脊椎動物-鳥類			
コブガモ	名前-自然物名-生物名-動物名-脊椎動物-鳥類			
コブハクチョウ	名前-自然物名-生物名-動物名-脊椎動物-鳥類			
コホオアカ	名前-自然物名-生物名-動物名-脊椎動物-鳥類			
コマミジロタヒバリ	名前-自然物名-生物名-動物名-脊椎動物-鳥類			
コミミズク	名前-自然物名-生物名-動物名-脊椎動物-鳥類			
コモンクイナ	名前-自然物名-生物名-動物名-脊椎動物-鳥類			
コモンシギ	名前-自然物名-生物名-動物名-脊椎動物-鳥類			
コーカサスイワヒバリ	名前-自然物名-生物名-動物名-脊椎動物-鳥類			
コーカサスクロライチョウ	名前-自然物名-生物名-動物名-脊椎動物-鳥類			
コーカサスセッケイ	名前-自然物名-生物名-動物名-脊椎動物-鳥類			
ゴイサギ	名前-自然物名-生物名-動物名-脊椎動物-鳥類			
ゴシキスズメヒバリ	名前-自然物名-生物名-動物名-脊椎動物-鳥類			
ゴシキヒワ	名前-自然物名-生物名-動物名-脊椎動物-鳥類			
ゴジュウカラ	名前-自然物名-生物名-動物名-脊椎動物-鳥類			
サケイ	名前-自然物名-生物名-動物名-脊椎動物-鳥類			
ササゴイ	名前-自然物名-生物名-動物名-脊椎動物-鳥類			
ササフサケイ	名前-自然物名-生物名-動物名-脊椎動物-鳥類			
サハライナバヒタキ	名前-自然物名-生物名-動物名-脊椎動物-鳥類			
サバクスズメ	名前-自然物名-生物名-動物名-脊椎動物-鳥類			
サバクヒタキ	名前-自然物名-生物名-動物名-脊椎動物-鳥類			
サバクフサエリショウノガン	名前-自然物名-生物名-動物名-脊椎動物-鳥類			
サバクマシコ	名前-自然物名-生物名-動物名-脊椎動物-鳥類			
サバクミミズク	名前-自然物名-生物名-動物名-脊椎動物-鳥類			
サバクムシクイ	名前-自然物名-生物名-動物名-脊椎動物-鳥類			
サバクヨタカ	名前-自然物名-生物名-動物名-脊椎動物-鳥類			
サヨナキドリ	名前-自然物名-生物名-動物名-脊椎動物-鳥類			
サルハマシギ	名前-自然物名-生物名-動物名-脊椎動物-鳥類			
サンカノゴイ	名前-自然物名-生物名-動物名-脊椎動物-鳥類			
サンドイッチアジサシ	名前-自然物名-生物名-動物名-脊椎動物-鳥類			
シッポウバト	名前-自然物名-生物名-動物名-脊椎動物-鳥類			
シベリアオオハシシギ	名前-自然物名-生物名-動物名-脊椎動物-鳥類			
シベリアセンニュウ	名前-自然物名-生物名-動物名-脊椎動物-鳥類			
シベリアチフチャフ	名前-自然物名-生物名-動物名-脊椎動物-鳥類			
シベリアムクドリ	名前-自然物名-生物名-動物名-脊椎動物-鳥類			
シベリアヨシキリ	名前-自然物名-生物名-動物名-脊椎動物-鳥類			
シマアオジ	名前-自然物名-生物名-動物名-脊椎動物-鳥類			
シマシャコ	名前-自然物名-生物名-動物名-脊椎動物-鳥類			
シマベニスズメ	名前-自然物名-生物名-動物名-脊椎動物-鳥類			
シマムシクイ	名前-自然物名-生物名-動物名-脊椎動物-鳥類			
シュバシコウ	名前-自然物名-生物名-動物名-脊椎動物-鳥類			
シュモクドリ	名前-自然物名-生物名-動物名-脊椎動物-鳥類			
ショウドウツバメ	名前-自然物名-生物名-動物名-脊椎動物-鳥類			
シラオネッタイチョウ	名前-自然物名-生物名-動物名-脊椎動物-鳥類			
シラガサバクヒタキ	名前-自然物名-生物名-動物名-脊椎動物-鳥類			
シラガツリスガラ	名前-自然物名-生物名-動物名-脊椎動物-鳥類			
シラガホオジロ	名前-自然物名-生物名-動物名-脊椎動物-鳥類			
シラコバト	名前-自然物名-生物名-動物名-脊椎動物-鳥類			
シラヒゲムシクイ	名前-自然物名-生物名-動物名-脊椎動物-鳥類			
シリアカヒヨドリ	名前-自然物名-生物名-動物名-脊椎動物-鳥類			
シリアセリン	名前-自然物名-生物名-動物名-脊椎動物-鳥類			
シロエリハゲワシ	名前-自然物名-生物名-動物名-脊椎動物-鳥類			
シロエリハサミアジサシ	名前-自然物名-生物名-動物名-脊椎動物-鳥類			
シロエリヒタキ	名前-自然物名-生物名-動物名-脊椎動物-鳥類			
シロカツオドリ	名前-自然物名-生物名-動物名-脊椎動物-鳥類			
シロカモメ	名前-自然物名-生物名-動物名-脊椎動物-鳥類			
シロガシラクロサバクヒタキ	名前-自然物名-生物名-動物名-脊椎動物-鳥類			
シロガシラクロヒヨドリ	名前-自然物名-生物名-動物名-脊椎動物-鳥類			
シロガシラジョウビタキ	名前-自然物名-生物名-動物名-脊椎動物-鳥類			
シロガシラトビ	名前-自然物名-生物名-動物名-脊椎動物-鳥類			
シロクロモズ	名前-自然物名-生物名-動物名-脊椎動物-鳥類			
シロチドリ	名前-自然物名-生物名-動物名-脊椎動物-鳥類			
シロハラアマツバメ	名前-自然物名-生物名-動物名-脊椎動物-鳥類			
シロハラウミツバメ	名前-自然物名-生物名-動物名-脊椎動物-鳥類			
シロハラクイナ	名前-自然物名-生物名-動物名-脊椎動物-鳥類			
シロハラサケイ	名前-自然物名-生物名-動物名-脊椎動物-鳥類			
シロハラチュウシャクシギ	名前-自然物名-生物名-動物名-脊椎動物-鳥類			
シロハラトウゾクカモメ	名前-自然物名-生物名-動物名-脊椎動物-鳥類			
シロハラミドリカッコウ	名前-自然物名-生物名-動物名-脊椎動物-鳥類			
シロハラムクドリ	名前-自然物名-生物名-動物名-脊椎動物-鳥類			
シロハラメジロ	名前-自然物名-生物名-動物名-脊椎動物-鳥類			
シロビタイジョウビタキ	名前-自然物名-生物名-動物名-脊椎動物-鳥類			
シロフクロウ	名前-自然物名-生物名-動物名-脊椎動物-鳥類			
シロボシマシコ	名前-自然物名-生物名-動物名-脊椎動物-鳥類			
シロミミヒヨドリ	名前-自然物名-生物名-動物名-脊椎動物-鳥類			
スゲヨシキリ	名前-自然物名-生物名-動物名-脊椎動物-鳥類			
スジカブリヤブチメドリ	名前-自然物名-生物名-動物名-脊椎動物-鳥類			
ススケカモメ	名前-自然物名-生物名-動物名-脊椎動物-鳥類			
スズガモ	名前-自然物名-生物名-動物名-脊椎動物-鳥類			
スナイロヤブチメドリ	名前-自然物名-生物名-動物名-脊椎動物-鳥類			
スナシャコ	名前-自然物名-生物名-動物名-脊椎動物-鳥類			
スナチムシクイ	名前-自然物名-生物名-動物名-脊椎動物-鳥類			
スナバシリ	名前-自然物名-生物名-動物名-脊椎動物-鳥類			
スナヒバリ	名前-自然物名-生物名-動物名-脊椎動物-鳥類			
スペインスズメ	名前-自然物名-生物名-動物名-脊椎動物-鳥類			
スミレスナバシリ	名前-自然物名-生物名-動物名-脊椎動物-鳥類			
ズアオアトリ	名前-自然物名-生物名-動物名-脊椎動物-鳥類			
ズアオカモメ	名前-自然物名-生物名-動物名-脊椎動物-鳥類			
ズアオホオジロ	名前-自然物名-生物名-動物名-脊椎動物-鳥類			
ズアカサンショクツバメ	名前-自然物名-生物名-動物名-脊椎動物-鳥類			
ズアカモズ	名前-自然物名-生物名-動物名-脊椎動物-鳥類			
ズキンハゲワシ	名前-自然物名-生物名-動物名-脊椎動物-鳥類			
ズキンミズナギドリ	名前-自然物名-生物名-動物名-脊椎動物-鳥類			
ズグロアオサギ	名前-自然物名-生物名-動物名-脊椎動物-鳥類			
ズグロゲリ	名前-自然物名-生物名-動物名-脊椎動物-鳥類			
ズグロサバクヒタキ	名前-自然物名-生物名-動物名-脊椎動物-鳥類			
ズグロスズメヒバリ	名前-自然物名-生物名-動物名-脊椎動物-鳥類			
ズグロチャキンチョウ	名前-自然物名-生物名-動物名-脊椎動物-鳥類			
ズグロツリスガラ	名前-自然物名-生物名-動物名-脊椎動物-鳥類			
ズグロミズナギドリ	名前-自然物名-生物名-動物名-脊椎動物-鳥類			
ズグロムクドリ	名前-自然物名-生物名-動物名-脊椎動物-鳥類			
ズグロムシクイ	名前-自然物名-生物名-動物名-脊椎動物-鳥類			
セアカジョウビタキ	名前-自然物名-生物名-動物名-脊椎動物-鳥類			
セアカモズ	名前-自然物名-生物名-動物名-脊椎動物-鳥類			
セイケイ	名前-自然物名-生物名-動物名-脊椎動物-鳥類			
セイタカシギ	名前-自然物名-生物名-動物名-脊椎動物-鳥類			
セグロアジサシ	名前-自然物名-生物名-動物名-脊椎動物-鳥類			
セグロカモメ	名前-自然物名-生物名-動物名-脊椎動物-鳥類			
セグロサバクヒタキ	名前-自然物名-生物名-動物名-脊椎動物-鳥類			
セグロミズナギドリ	名前-自然物名-生物名-動物名-脊椎動物-鳥類			
セジロサバクヒタキ	名前-自然物名-生物名-動物名-脊椎動物-鳥類			
セジロタヒバリ	名前-自然物名-生物名-動物名-脊椎動物-鳥類			
セスジハウチワドリ	名前-自然物名-生物名-動物名-脊椎動物-鳥類			
セッカ	名前-自然物名-生物名-動物名-脊椎動物-鳥類			
セネガルサケイ	名前-自然物名-生物名-動物名-脊椎動物-鳥類			
セネガルバンケン	名前-自然物名-生物名-動物名-脊椎動物-鳥類			
セーカーハヤブサ	名前-自然物名-生物名-動物名-脊椎動物-鳥類			
ソウゲンワシ	名前-自然物名-生物名-動物名-脊椎動物-鳥類			
ソコトラアマツバメ	名前-自然物名-生物名-動物名-脊椎動物-鳥類			
ソコトラスズメ	名前-自然物名-生物名-動物名-脊椎動物-鳥類			
ソコトラセッカ	名前-自然物名-生物名-動物名-脊椎動物-鳥類			
ソコトラタイヨウチョウ	名前-自然物名-生物名-動物名-脊椎動物-鳥類			
ソコトラテリムク	名前-自然物名-生物名-動物名-脊椎動物-鳥類			
ソコトラホオジロ	名前-自然物名-生物名-動物名-脊椎動物-鳥類			
ソコトラムシクイ	名前-自然物名-生物名-動物名-脊椎動物-鳥類			
ソデグロヅル	名前-自然物名-生物名-動物名-脊椎動物-鳥類			
ソマリーテリムク	名前-自然物名-生物名-動物名-脊椎動物-鳥類			
ソマリーハチクイ	名前-自然物名-生物名-動物名-脊椎動物-鳥類			
ソマリーヒメコウテンシ	名前-自然物名-生物名-動物名-脊椎動物-鳥類			
ソリハシオオイシチドリ	名前-自然物名-生物名-動物名-脊椎動物-鳥類			
ソリハシシギ	名前-自然物名-生物名-動物名-脊椎動物-鳥類			
ソリハシセイタカシギ	名前-自然物名-生物名-動物名-脊椎動物-鳥類			
タイリクハクセキレイ	名前-自然物名-生物名-動物名-脊椎動物-鳥類			
タイワンショウドウツバメ	名前-自然物名-生物名-動物名-脊椎動物-鳥類			
タイワンヒバリ	名前-自然物名-生物名-動物名-脊椎動物-鳥類			
タカサゴダカ	名前-自然物名-生物名-動物名-脊椎動物-鳥類			
タカサゴモズ	名前-自然物名-生物名-動物名-脊椎動物-鳥類			
クロシチホウ	名前-自然物名-生物名-動物名-脊椎動物-鳥類			
タカブシギ	名前-自然物名-生物名-動物名-脊椎動物-鳥類			
タゲリ	名前-自然物名-生物名-動物名-脊椎動物-鳥類			
タシギ	名前-自然物名-生物名-動物名-脊椎動物-鳥類			
タヒバリ	名前-自然物名-生物名-動物名-脊椎動物-鳥類			
タマシギ	名前-自然物名-生物名-動物名-脊椎動物-鳥類			
タンシキバシリ	名前-自然物名-生物名-動物名-脊椎動物-鳥類			
ダイサギ	名前-自然物名-生物名-動物名-脊椎動物-鳥類			
ダイシャクシギ	名前-自然物名-生物名-動物名-脊椎動物-鳥類			
ダイゼン	名前-自然物名-生物名-動物名-脊椎動物-鳥類			
ダルマワシ	名前-自然物名-生物名-動物名-脊椎動物-鳥類			
チゴハヤブサ	名前-自然物名-生物名-動物名-脊椎動物-鳥類			
チチュウカイミズナギドリ	名前-自然物名-生物名-動物名-脊椎動物-鳥類			
チビオガラス	名前-自然物名-生物名-動物名-脊椎動物-鳥類			
チフチャフ	名前-自然物名-生物名-動物名-脊椎動物-鳥類			
チャイロツバメ	名前-自然物名-生物名-動物名-脊椎動物-鳥類			
チャイロハヤシムシクイ	名前-自然物名-生物名-動物名-脊椎動物-鳥類			
チャイロヤブモズ	名前-自然物名-生物名-動物名-脊椎動物-鳥類			
チャエリイワシャコ	名前-自然物名-生物名-動物名-脊椎動物-鳥類			
チャエリガラス	名前-自然物名-生物名-動物名-脊椎動物-鳥類			
チャガシラカモメ	名前-自然物名-生物名-動物名-脊椎動物-鳥類			
チャガシラニシブッポウソウ	名前-自然物名-生物名-動物名-脊椎動物-鳥類			
チャキンチョウ	名前-自然物名-生物名-動物名-脊椎動物-鳥類			
チャゴシサバクヒタキ	名前-自然物名-生物名-動物名-脊椎動物-鳥類			
チャバラサケイ	名前-自然物名-生物名-動物名-脊椎動物-鳥類			
チャバラヒメクイナ	名前-自然物名-生物名-動物名-脊椎動物-鳥類			
チャバラムシクイ	名前-自然物名-生物名-動物名-脊椎動物-鳥類			
チャムネサバクヒタキ	名前-自然物名-生物名-動物名-脊椎動物-鳥類			
チュウサギ	名前-自然物名-生物名-動物名-脊椎動物-鳥類			
チュウシャクシギ	名前-自然物名-生物名-動物名-脊椎動物-鳥類			
チュウジシギ	名前-自然物名-生物名-動物名-脊椎動物-鳥類			
チュウヒワシ	名前-自然物名-生物名-動物名-脊椎動物-鳥類			
チュウヨシキリ	名前-自然物名-生物名-動物名-脊椎動物-鳥類			
チョウゲンボウ	名前-自然物名-生物名-動物名-脊椎動物-鳥類			
ツクシガモ	名前-自然物名-生物名-動物名-脊椎動物-鳥類			
ツツドリ	名前-自然物名-生物名-動物名-脊椎動物-鳥類			
ツバメゲリ	名前-自然物名-生物名-動物名-脊椎動物-鳥類			
ツバメチドリ	名前-自然物名-生物名-動物名-脊椎動物-鳥類			
ツメナガセキレイ	名前-自然物名-生物名-動物名-脊椎動物-鳥類			
ツメナガホオジロ	名前-自然物名-生物名-動物名-脊椎動物-鳥類			
ツメバガン	名前-自然物名-生物名-動物名-脊椎動物-鳥類			
ツルクイナ	名前-自然物名-生物名-動物名-脊椎動物-鳥類			
ツルシギ	名前-自然物名-生物名-動物名-脊椎動物-鳥類			
テリタイヨウチョウ	名前-自然物名-生物名-動物名-脊椎動物-鳥類			
デュボンヒバリ	名前-自然物名-生物名-動物名-脊椎動物-鳥類			
トウゾクカモメ	名前-自然物名-生物名-動物名-脊椎動物-鳥類			
トウネン	名前-自然物名-生物名-動物名-脊椎動物-鳥類			
トサカムクドリ	名前-自然物名-生物名-動物名-脊椎動物-鳥類			
トモエガモ	名前-自然物名-生物名-動物名-脊椎動物-鳥類			
トラツグミ	名前-自然物名-生物名-動物名-脊椎動物-鳥類			
トラフズク	名前-自然物名-生物名-動物名-脊椎動物-鳥類			
ナイルタイヨウチョウ	名前-自然物名-生物名-動物名-脊椎動物-鳥類			
ナイルチドリ	名前-自然物名-生物名-動物名-脊椎動物-鳥類			
ナキマシコ	名前-自然物名-生物名-動物名-脊椎動物-鳥類			
ナナスジホオジロ	名前-自然物名-生物名-動物名-脊椎動物-鳥類			
ナベコウ	名前-自然物名-生物名-動物名-脊椎動物-鳥類			
ナンキョクオオトウゾクカモメ	名前-自然物名-生物名-動物名-脊椎動物-鳥類			
ナンキンオシ	名前-自然物名-生物名-動物名-脊椎動物-鳥類			
ナンヨウショウビン	名前-自然物名-生物名-動物名-脊椎動物-鳥類			
ニシアカアシチョウゲンボウ	名前-自然物名-生物名-動物名-脊椎動物-鳥類			
ニシイワツバメ	名前-自然物名-生物名-動物名-脊椎動物-鳥類			
ニシオオチドリ	名前-自然物名-生物名-動物名-脊椎動物-鳥類			
ニシオオノスリ	名前-自然物名-生物名-動物名-脊椎動物-鳥類			
ニシオオヨシキリ	名前-自然物名-生物名-動物名-脊椎動物-鳥類			
ニシキスズメ	名前-自然物名-生物名-動物名-脊椎動物-鳥類			
ニシコウライウグイス	名前-自然物名-生物名-動物名-脊椎動物-鳥類			
ニシコクマルガラス	名前-自然物名-生物名-動物名-脊椎動物-鳥類			
ニシズグロカモメ	名前-自然物名-生物名-動物名-脊椎動物-鳥類			
ニシセグロカモメ	名前-自然物名-生物名-動物名-脊椎動物-鳥類			
ニシセンダイムシクイ	名前-自然物名-生物名-動物名-脊椎動物-鳥類			
ニシツバメチドリ	名前-自然物名-生物名-動物名-脊椎動物-鳥類			
ニシツリスガラ	名前-自然物名-生物名-動物名-脊椎動物-鳥類			
ニシトビ	名前-自然物名-生物名-動物名-脊椎動物-鳥類			
ニシノビタキ	名前-自然物名-生物名-動物名-脊椎動物-鳥類			
ニシハイイロペリカン	名前-自然物名-生物名-動物名-脊椎動物-鳥類			
ニシヒバリ	名前-自然物名-生物名-動物名-脊椎動物-鳥類			
ニシヒメアマツバメ	名前-自然物名-生物名-動物名-脊椎動物-鳥類			
ニシブッポウソウ	名前-自然物名-生物名-動物名-脊椎動物-鳥類			
ニワムシクイ	名前-自然物名-生物名-動物名-脊椎動物-鳥類			
ヌマセンニュウ	名前-自然物名-生物名-動物名-脊椎動物-鳥類			
ヌマヨシキリ	名前-自然物名-生物名-動物名-脊椎動物-鳥類			
ネズミオナガムシクイ	名前-自然物名-生物名-動物名-脊椎動物-鳥類			
ノウメンスズメ	名前-自然物名-生物名-動物名-脊椎動物-鳥類			
ノガン	名前-自然物名-生物名-動物名-脊椎動物-鳥類			
ノスリ	名前-自然物名-生物名-動物名-脊椎動物-鳥類			
ノドアカホオジロ	名前-自然物名-生物名-動物名-脊椎動物-鳥類			
ノドグロアオジ	名前-自然物名-生物名-動物名-脊椎動物-鳥類			
ノドグロイワシャコ	名前-自然物名-生物名-動物名-脊椎動物-鳥類			
ノドグロイワヒバリ	名前-自然物名-生物名-動物名-脊椎動物-鳥類			
ノドグロツグミ	名前-自然物名-生物名-動物名-脊椎動物-鳥類			
ノドグロムシクイ	名前-自然物名-生物名-動物名-脊椎動物-鳥類			
ノドジロコマドリ	名前-自然物名-生物名-動物名-脊椎動物-鳥類			
ノドジロハチクイ	名前-自然物名-生物名-動物名-脊椎動物-鳥類			
ノドジロムシクイ	名前-自然物名-生物名-動物名-脊椎動物-鳥類			
ノハラツグミ	名前-自然物名-生物名-動物名-脊椎動物-鳥類			
ノビタキ	名前-自然物名-生物名-動物名-脊椎動物-鳥類			
ハイイロアマツバメ	名前-自然物名-生物名-動物名-脊椎動物-鳥類			
ハイイロイワシャコ	名前-自然物名-生物名-動物名-脊椎動物-鳥類			
ハイイロイワビタキ	名前-自然物名-生物名-動物名-脊椎動物-鳥類			
ハイイロウタムシクイ	名前-自然物名-生物名-動物名-脊椎動物-鳥類			
ハイイロガン	名前-自然物名-生物名-動物名-脊椎動物-鳥類			
ハイイロコサイチョウ	名前-自然物名-生物名-動物名-脊椎動物-鳥類			
ハイイロチュウヒ	名前-自然物名-生物名-動物名-脊椎動物-鳥類			
ハイイロハッカ	名前-自然物名-生物名-動物名-脊椎動物-鳥類			
ハイイロヒレアシシギ	名前-自然物名-生物名-動物名-脊椎動物-鳥類			
ハイイロミズナギドリ	名前-自然物名-生物名-動物名-脊椎動物-鳥類			
ハイガシラショウビン	名前-自然物名-生物名-動物名-脊椎動物-鳥類			
ハイガシラホオジロ	名前-自然物名-生物名-動物名-脊椎動物-鳥類			
ハイタカ	名前-自然物名-生物名-動物名-脊椎動物-鳥類			
ハイタカジュウイチ	名前-自然物名-生物名-動物名-脊椎動物-鳥類			
ハイバラメジロ	名前-自然物名-生物名-動物名-脊椎動物-鳥類			
ハクガン	名前-自然物名-生物名-動物名-脊椎動物-鳥類			
ハグロツバメチドリ	名前-自然物名-生物名-動物名-脊椎動物-鳥類			
ハシグロアビ	名前-自然物名-生物名-動物名-脊椎動物-鳥類			
ハシグロクロハラアジサシ	名前-自然物名-生物名-動物名-脊椎動物-鳥類			
ハシグロナキマシコ	名前-自然物名-生物名-動物名-脊椎動物-鳥類			
ハシグロヒタキ	名前-自然物名-生物名-動物名-脊椎動物-鳥類			
ハシナガヒバリ	名前-自然物名-生物名-動物名-脊椎動物-鳥類			
ハシナガビンズイ	名前-自然物名-生物名-動物名-脊椎動物-鳥類			
ハシビロガモ	名前-自然物名-生物名-動物名-脊椎動物-鳥類			
ハシブトアジサシ	名前-自然物名-生物名-動物名-脊椎動物-鳥類			
ハシブトガラ	名前-自然物名-生物名-動物名-脊椎動物-鳥類			
ハシブトガラス	名前-自然物名-生物名-動物名-脊椎動物-鳥類			
ハシブトヒバリ	名前-自然物名-生物名-動物名-脊椎動物-鳥類			
ハシボソカモメ	名前-自然物名-生物名-動物名-脊椎動物-鳥類			
ハシボソガラス	名前-自然物名-生物名-動物名-脊椎動物-鳥類			
ハシボソヨシキリ	名前-自然物名-生物名-動物名-脊椎動物-鳥類			
ハジロアカゲラ	名前-自然物名-生物名-動物名-脊椎動物-鳥類			
ハジロアホウドリ	名前-自然物名-生物名-動物名-脊椎動物-鳥類			
ハジロカイツブリ	名前-自然物名-生物名-動物名-脊椎動物-鳥類			
ハジロクロシメ	名前-自然物名-生物名-動物名-脊椎動物-鳥類			
ハジロクロハラアジサシ	名前-自然物名-生物名-動物名-脊椎動物-鳥類			
ハジロコウテンシ	名前-自然物名-生物名-動物名-脊椎動物-鳥類			
ハジロコチドリ	名前-自然物名-生物名-動物名-脊椎動物-鳥類			
ハタホオジロ	名前-自然物名-生物名-動物名-脊椎動物-鳥類			
ハチクマ	名前-自然物名-生物名-動物名-脊椎動物-鳥類			
ハチマキジョウビタキ	名前-自然物名-生物名-動物名-脊椎動物-鳥類			
ハマシギ	名前-自然物名-生物名-動物名-脊椎動物-鳥類			
ハマヒバリ	名前-自然物名-生物名-動物名-脊椎動物-鳥類			
ハリオシギ	名前-自然物名-生物名-動物名-脊椎動物-鳥類			
ハリオツバメ	名前-自然物名-生物名-動物名-脊椎動物-鳥類			
ハンエリヒタキ	名前-自然物名-生物名-動物名-脊椎動物-鳥類			
バスラオオヨシキリ	名前-自然物名-生物名-動物名-脊椎動物-鳥類			
バフマユムシクイ	名前-自然物名-生物名-動物名-脊椎動物-鳥類			
バライロシラコバト	名前-自然物名-生物名-動物名-脊椎動物-鳥類			
バライロムクドリ	名前-自然物名-生物名-動物名-脊椎動物-鳥類			
バルカンコガラ	名前-自然物名-生物名-動物名-脊椎動物-鳥類			
バーバリーハヤブサ	名前-自然物名-生物名-動物名-脊椎動物-鳥類			
ヒガシイワゴジュウカラ	名前-自然物名-生物名-動物名-脊椎動物-鳥類			
ヒガシヒメモリバト	名前-自然物名-生物名-動物名-脊椎動物-鳥類			
ヒガシボネリームシクイ	名前-自然物名-生物名-動物名-脊椎動物-鳥類			
ヒガラ	名前-自然物名-生物名-動物名-脊椎動物-鳥類			
ヒゲガラ	名前-自然物名-生物名-動物名-脊椎動物-鳥類			
ヒゲホオジロ	名前-自然物名-生物名-動物名-脊椎動物-鳥類			
ヒゲワシ	名前-自然物名-生物名-動物名-脊椎動物-鳥類			
ヒシクイ	名前-自然物名-生物名-動物名-脊椎動物-鳥類			
ヒドリガモ	名前-自然物名-生物名-動物名-脊椎動物-鳥類			
ヒバリシギ	名前-自然物名-生物名-動物名-脊椎動物-鳥類			
ヒマラヤアオゲラ	名前-自然物名-生物名-動物名-脊椎動物-鳥類			
ヒマラヤコヒバリ	名前-自然物名-生物名-動物名-脊椎動物-鳥類			
ヒマラヤセッケイ	名前-自然物名-生物名-動物名-脊椎動物-鳥類			
ヒメアカゲラ	名前-自然物名-生物名-動物名-脊椎動物-鳥類			
ヒメイワシャコ	名前-自然物名-生物名-動物名-脊椎動物-鳥類			
ヒメウズラシギ	名前-自然物名-生物名-動物名-脊椎動物-鳥類			
ヒメウタムシクイ	名前-自然物名-生物名-動物名-脊椎動物-鳥類			
ヒメウミツバメ	名前-自然物名-生物名-動物名-脊椎動物-鳥類			
ヒメオオモズ	名前-自然物名-生物名-動物名-脊椎動物-鳥類			
ヒメカッコウ	名前-自然物名-生物名-動物名-脊椎動物-鳥類			
ヒメカモメ	名前-自然物名-生物名-動物名-脊椎動物-鳥類			
ヒメクイナ	名前-自然物名-生物名-動物名-脊椎動物-鳥類			
ヒメクマタカ	名前-自然物名-生物名-動物名-脊椎動物-鳥類			
ヒメクロウミツバメ	名前-自然物名-生物名-動物名-脊椎動物-鳥類			
ヒメコウテンシ	名前-自然物名-生物名-動物名-脊椎動物-鳥類			
ヒメチドリ	名前-自然物名-生物名-動物名-脊椎動物-鳥類			
ヒメチョウゲンボウ	名前-自然物名-生物名-動物名-脊椎動物-鳥類			
ヒメツバメチドリ	名前-自然物名-生物名-動物名-脊椎動物-鳥類			
ヒメノガン	名前-自然物名-生物名-動物名-脊椎動物-鳥類			
ヒメハイイロチュウヒ	名前-自然物名-生物名-動物名-脊椎動物-鳥類			
ヒメバン	名前-自然物名-生物名-動物名-脊椎動物-鳥類			
ヒメミズナギドリ	名前-自然物名-生物名-動物名-脊椎動物-鳥類			
ヒメモリバト	名前-自然物名-生物名-動物名-脊椎動物-鳥類			
ヒメヤマセミ	名前-自然物名-生物名-動物名-脊椎動物-鳥類			
ヒメヨシゴイ	名前-自然物名-生物名-動物名-脊椎動物-鳥類			
ヒレアシトウネン	名前-自然物名-生物名-動物名-脊椎動物-鳥類			
ビロードキンクロ	名前-自然物名-生物名-動物名-脊椎動物-鳥類			
ビンズイ	名前-自然物名-生物名-動物名-脊椎動物-鳥類			
フサエリショウノガン	名前-自然物名-生物名-動物名-脊椎動物-鳥類			
ブロンズトキ	名前-自然物名-生物名-動物名-脊椎動物-鳥類			
ブロンズミドリカッコウ	名前-自然物名-生物名-動物名-脊椎動物-鳥類			
プラユーン・シャオワッタナー 	名前-自然物名-生物名-動物名-脊椎動物-鳥類			
ヘラサギ	名前-自然物名-生物名-動物名-脊椎動物-鳥類			
ベニアジサシ	名前-自然物名-生物名-動物名-脊椎動物-鳥類			
ベニスズメ	名前-自然物名-生物名-動物名-脊椎動物-鳥類			
ベニノジコ	名前-自然物名-生物名-動物名-脊椎動物-鳥類			
ベニハシガラス	名前-自然物名-生物名-動物名-脊椎動物-鳥類			
ベニバト	名前-自然物名-生物名-動物名-脊椎動物-鳥類			
ベニバネナキマシコ	名前-自然物名-生物名-動物名-脊椎動物-鳥類			
ベニヒタイセリン	名前-自然物名-生物名-動物名-脊椎動物-鳥類			
ベニヒワ	名前-自然物名-生物名-動物名-脊椎動物-鳥類			
ベンガルアジサシ	名前-自然物名-生物名-動物名-脊椎動物-鳥類			
ベンガルハゲワシ	名前-自然物名-生物名-動物名-脊椎動物-鳥類			
ペルシァスズメ	名前-自然物名-生物名-動物名-脊椎動物-鳥類			
ペルシアミズナギドリ	名前-自然物名-生物名-動物名-脊椎動物-鳥類			
ペルシャウ	名前-自然物名-生物名-動物名-脊椎動物-鳥類			
ホウロクシギ	名前-自然物名-生物名-動物名-脊椎動物-鳥類			
ホオアカトキ	名前-自然物名-生物名-動物名-脊椎動物-鳥類			
ホオジロガモ	名前-自然物名-生物名-動物名-脊椎動物-鳥類			
ホオジロヒヨドリ	名前-自然物名-生物名-動物名-脊椎動物-鳥類			
ホシガラス	名前-自然物名-生物名-動物名-脊椎動物-鳥類			
ホシハジロ	名前-自然物名-生物名-動物名-脊椎動物-鳥類			
ホシムクドリ	名前-自然物名-生物名-動物名-脊椎動物-鳥類			
ホロホロチョウ	名前-自然物名-生物名-動物名-脊椎動物-鳥類			
ホンケワタガモ	名前-自然物名-生物名-動物名-脊椎動物-鳥類			
ホンセイインコ	名前-自然物名-生物名-動物名-脊椎動物-鳥類			
ボナパルトカモメ	名前-自然物名-生物名-動物名-脊椎動物-鳥類			
ボネリークマタカ	名前-自然物名-生物名-動物名-脊椎動物-鳥類			
ボネリームシクイ	名前-自然物名-生物名-動物名-脊椎動物-鳥類			
ボハラシジュウカラ	名前-自然物名-生物名-動物名-脊椎動物-鳥類			
マガン	名前-自然物名-生物名-動物名-脊椎動物-鳥類			
マキバタヒバリ	名前-自然物名-生物名-動物名-脊椎動物-鳥類			
マキバドリモドキ	名前-自然物名-生物名-動物名-脊椎動物-鳥類			
マダガスカルハチクイ	名前-自然物名-生物名-動物名-脊椎動物-鳥類			
マダラカンムリカッコウ	名前-自然物名-生物名-動物名-脊椎動物-鳥類			
マダラハゲワシ	名前-自然物名-生物名-動物名-脊椎動物-鳥類			
マダラヒタキ	名前-自然物名-生物名-動物名-脊椎動物-鳥類			
マデイラミズナギドリ	名前-自然物名-生物名-動物名-脊椎動物-鳥類			
マヒワ	名前-自然物名-生物名-動物名-脊椎動物-鳥類			
マミジロ	名前-自然物名-生物名-動物名-脊椎動物-鳥類			
マミジロアジサシ	名前-自然物名-生物名-動物名-脊椎動物-鳥類			
マミジロキクイタダキ	名前-自然物名-生物名-動物名-脊椎動物-鳥類			
マミジロゲリ	名前-自然物名-生物名-動物名-脊椎動物-鳥類			
マミジロタヒバリ	名前-自然物名-生物名-動物名-脊椎動物-鳥類			
マミジロノビタキ	名前-自然物名-生物名-動物名-脊椎動物-鳥類			
マミジロバンケン	名前-自然物名-生物名-動物名-脊椎動物-鳥類			
マミジロヨシキリ	名前-自然物名-生物名-動物名-脊椎動物-鳥類			
マミチャジナイ	名前-自然物名-生物名-動物名-脊椎動物-鳥類			
マユジロショウドウツバメ	名前-自然物名-生物名-動物名-脊椎動物-鳥類			
マンクスミズナギドリ	名前-自然物名-生物名-動物名-脊椎動物-鳥類			
ミコアイサ	名前-自然物名-生物名-動物名-脊椎動物-鳥類			
ミソサザイ	名前-自然物名-生物名-動物名-脊椎動物-鳥類			
ミツユビカモメ	名前-自然物名-生物名-動物名-脊椎動物-鳥類			
ミドリハチクイ	名前-自然物名-生物名-動物名-脊椎動物-鳥類			
ミドリムシクイ	名前-自然物名-生物名-動物名-脊椎動物-鳥類			
ミナミオオトウゾクカモメ	名前-自然物名-生物名-動物名-脊椎動物-鳥類			
ミナミオオモズ	名前-自然物名-生物名-動物名-脊椎動物-鳥類			
ミナミシマフクロウ	名前-自然物名-生物名-動物名-脊椎動物-鳥類			
ミナミノドジロムシクイ	名前-自然物名-生物名-動物名-脊椎動物-鳥類			
ミミカイツブリ	名前-自然物名-生物名-動物名-脊椎動物-鳥類			
ミミグロレンジャクモドキ	名前-自然物名-生物名-動物名-脊椎動物-鳥類			
ミミヒダハゲワシ	名前-自然物名-生物名-動物名-脊椎動物-鳥類			
ミヤコドリ	名前-自然物名-生物名-動物名-脊椎動物-鳥類			
ミヤマガラス	名前-自然物名-生物名-動物名-脊椎動物-鳥類			
ミヤマチフチャフ	名前-自然物名-生物名-動物名-脊椎動物-鳥類			
ミユビシギ	名前-自然物名-生物名-動物名-脊椎動物-鳥類			
ムジセッカ	名前-自然物名-生物名-動物名-脊椎動物-鳥類			
ムジタヒバリ	名前-自然物名-生物名-動物名-脊椎動物-鳥類			
ムジホシムクドリ	名前-自然物名-生物名-動物名-脊椎動物-鳥類			
ムジヨタカ	名前-自然物名-生物名-動物名-脊椎動物-鳥類			
ムナオビゴジュウカラ	名前-自然物名-生物名-動物名-脊椎動物-鳥類			
ムナグロ	名前-自然物名-生物名-動物名-脊椎動物-鳥類			
ムナグロシャコ	名前-自然物名-生物名-動物名-脊椎動物-鳥類			
ムナジロカワガラス	名前-自然物名-生物名-動物名-脊椎動物-鳥類			
ムナジロガラス	名前-自然物名-生物名-動物名-脊椎動物-鳥類			
ムナフヒタキ	名前-自然物名-生物名-動物名-脊椎動物-鳥類			
ムネアカタヒバリ	名前-自然物名-生物名-動物名-脊椎動物-鳥類			
ムネアカヒワ	名前-自然物名-生物名-動物名-脊椎動物-鳥類			
ムネアカマシコ	名前-自然物名-生物名-動物名-脊椎動物-鳥類			
ムラサキサギ	名前-自然物名-生物名-動物名-脊椎動物-鳥類			
ムラサキタイヨウチョウ	名前-自然物名-生物名-動物名-脊椎動物-鳥類			
メジロカモメ	名前-自然物名-生物名-動物名-脊椎動物-鳥類			
メジロガモ	名前-自然物名-生物名-動物名-脊椎動物-鳥類			
メジロサシバ	名前-自然物名-生物名-動物名-脊椎動物-鳥類			
メジロムシクイ	名前-自然物名-生物名-動物名-脊椎動物-鳥類			
メダイチドリ	名前-自然物名-生物名-動物名-脊椎動物-鳥類			
メネトリームシクイ	名前-自然物名-生物名-動物名-脊椎動物-鳥類			
メボソムシクイ	名前-自然物名-生物名-動物名-脊椎動物-鳥類			
メンハタオリドリ	名前-自然物名-生物名-動物名-脊椎動物-鳥類			
メンフクロウ	名前-自然物名-生物名-動物名-脊椎動物-鳥類			
モウコナキマシコ	名前-自然物名-生物名-動物名-脊椎動物-鳥類			
モモイロペリカン	名前-自然物名-生物名-動物名-脊椎動物-鳥類			
モリバト	名前-自然物名-生物名-動物名-脊椎動物-鳥類			
モリヒバリ	名前-自然物名-生物名-動物名-脊椎動物-鳥類			
モリフクロウ	名前-自然物名-生物名-動物名-脊椎動物-鳥類			
モリムシクイ	名前-自然物名-生物名-動物名-脊椎動物-鳥類			
モロッコアオゲラ	名前-自然物名-生物名-動物名-脊椎動物-鳥類			
ヤクシャウズラ	名前-自然物名-生物名-動物名-脊椎動物-鳥類			
ヤシアマツバメ	名前-自然物名-生物名-動物名-脊椎動物-鳥類			
ヤチセンニュウ	名前-自然物名-生物名-動物名-脊椎動物-鳥類			
ヤドリギツグミ	名前-自然物名-生物名-動物名-脊椎動物-鳥類			
ヤナギムシクイ	名前-自然物名-生物名-動物名-脊椎動物-鳥類			
ヤブイワスズメ	名前-自然物名-生物名-動物名-脊椎動物-鳥類			
ヤブサヨナキドリ	名前-自然物名-生物名-動物名-脊椎動物-鳥類			
ヤマゲラ	名前-自然物名-生物名-動物名-脊椎動物-鳥類			
ヤマシギ	名前-自然物名-生物名-動物名-脊椎動物-鳥類			
ヤマヒバリ	名前-自然物名-生物名-動物名-脊椎動物-鳥類			
ユキスズメ	名前-自然物名-生物名-動物名-脊椎動物-鳥類			
ユキホオジロ	名前-自然物名-生物名-動物名-脊椎動物-鳥類			
ヨシガモ	名前-自然物名-生物名-動物名-脊椎動物-鳥類			
ヨーロッパアオゲラ	名前-自然物名-生物名-動物名-脊椎動物-鳥類			
ヨーロッパアマツバメ	名前-自然物名-生物名-動物名-脊椎動物-鳥類			
ヨーロッパウグイス	名前-自然物名-生物名-動物名-脊椎動物-鳥類			
ヨーロッパウズラ	名前-自然物名-生物名-動物名-脊椎動物-鳥類			
ヨーロッパカヤクグリ	名前-自然物名-生物名-動物名-脊椎動物-鳥類			
ヨーロッパコノハズク	名前-自然物名-生物名-動物名-脊椎動物-鳥類			
ヨーロッパコマドリ	名前-自然物名-生物名-動物名-脊椎動物-鳥類			
ヨーロッパジシギ	名前-自然物名-生物名-動物名-脊椎動物-鳥類			
ヨーロッパタヒバリ	名前-自然物名-生物名-動物名-脊椎動物-鳥類			
ヨーロッパチュウヒ	名前-自然物名-生物名-動物名-脊椎動物-鳥類			
ヨーロッパトウネン	名前-自然物名-生物名-動物名-脊椎動物-鳥類			
ヨーロッパハチクイ	名前-自然物名-生物名-動物名-脊椎動物-鳥類			
ヨーロッパハチクマ	名前-自然物名-生物名-動物名-脊椎動物-鳥類			
ヨーロッパヒメウ	名前-自然物名-生物名-動物名-脊椎動物-鳥類			
ヨーロッパビンズイ	名前-自然物名-生物名-動物名-脊椎動物-鳥類			
ヨーロッパムナグロ	名前-自然物名-生物名-動物名-脊椎動物-鳥類			
ヨーロッパヤマウズラ	名前-自然物名-生物名-動物名-脊椎動物-鳥類			
ヨーロッパヨシキリ	名前-自然物名-生物名-動物名-脊椎動物-鳥類			
ヨーロッパヨタカ	名前-自然物名-生物名-動物名-脊椎動物-鳥類			
ライラックニシブッポウソウ	名前-自然物名-生物名-動物名-脊椎動物-鳥類			
ラガーハヤブサ	名前-自然物名-生物名-動物名-脊椎動物-鳥類			
ラナーハヤブサ	名前-自然物名-生物名-動物名-脊椎動物-鳥類			
リュウキュウガモ	名前-自然物名-生物名-動物名-脊椎動物-鳥類			
ルリガラ	名前-自然物名-生物名-動物名-脊椎動物-鳥類			
ルリビタキ	名前-自然物名-生物名-動物名-脊椎動物-鳥類			
ルリホオハチクイ	名前-自然物名-生物名-動物名-脊椎動物-鳥類			
レバントハイタカ	名前-自然物名-生物名-動物名-脊椎動物-鳥類			
レンカク	名前-自然物名-生物名-動物名-脊椎動物-鳥類			
ワキアカツグミ	名前-自然物名-生物名-動物名-脊椎動物-鳥類			
ワシミミズク	名前-自然物名-生物名-動物名-脊椎動物-鳥類			
ワタリガラス	名前-自然物名-生物名-動物名-脊椎動物-鳥類			
ワライバト	名前-自然物名-生物名-動物名-脊椎動物-鳥類			
空気	名前-自然物名-物質名	固有名詞ではない		
コンスタンタン	名前-自然物名-物質名			
シトシン	名前-自然物名-物質名			
ビニルアルコール	名前-自然物名-物質名			
姓	名前-称号名-地位名			
武将	名前-称号名-地位名			
総務大臣	名前-称号名-地位名			
被疑者	名前-称号名-地位名			
関東管領	名前-称号名-地位名			
ボーカル	名前-職業名	???		
AV女優	名前-職業名			
アーティスト	名前-職業名			
作曲家	名前-職業名			
作詞家	名前-職業名			
守護	名前-職業名			
在原氏	名前-組織名-組織名_その他			
富樫氏	名前-組織名-組織名_その他			
山内上杉氏	名前-組織名-組織名_その他			
HISASHI	名前-人名			
akiko	名前-人名			
アイザック・ニュートン	名前-人名			
アイリーン・アドラー	名前-人名			
アラゴルン	名前-人名			
アラン・チューリング	名前-人名			
アレッサンドロ・ボルタ	名前-人名			
アーゲ・フリース	名前-人名			
アーネスト・ラザフォード	名前-人名			
ウエンツ瑛士	名前-人名			
エアレンディル	名前-人名			
エルンスト・フリース	名前-人名			
オリバー・クロムウェル	名前-人名			
カレン・カーペンター	名前-人名			
クリス・モンテス	名前-人名			
クロディーヌ・ロンジュ	名前-人名			
シメ	名前-人名			
シャーロック・ホームズ	名前-人名			
シーン・モーリー	名前-人名			
ジェリー・モス	名前-人名			
ジェームズ・モリアーティー	名前-人名			
ジェームズ・ワトソン	名前-人名			
ジャネット・ジャクソン	名前-人名			
ジョン・F・ケネディ	名前-人名			
ジョン・H・ワトスン	名前-人名			
ジョン・ボウルビィ	名前-人名			
ジョン・ミルトン	名前-人名			
ジョン・メイナード・ケインズ	名前-人名			
ジョー・コッカー	名前-人名			
ジョー・ジャクソン	名前-人名			
ジーン・クラーク	名前-人名			
スザンヌ・ヴェガ	名前-人名			
スティーヴン・ホーキング	名前-人名			
セルジオ・メンデス	名前-人名			
チャールズ・ダーウィン	名前-人名			
デヴォンシァ公ウィリアム・キャベンディッシュ	名前-人名			
"ノビコフ, プリボイ"	名前-人名			
ハーブ・アルパート	名前-人名			
バートランド・ラッセル	名前-人名			
バート・バカラック	名前-人名			
パルパティーン	名前-人名			
ピーター・フランプトン	名前-人名			
フランシス・フォード・コッポラ	名前-人名			
フランツ・カフカ	名前-人名			
フランツ・フォン・シュトゥック	名前-人名			
ブライアン・アダムス	名前-人名			
ホレイショ・ネルソン	名前-人名			
ポール・ウィリアムズ	名前-人名			
マルチン・ゲルリッツエン・フリース	名前-人名			
モンキー・パンチ	名前-人名			
ヤーコプ・フリードリヒ・フリース	名前-人名			
リタ・クーリッジ	名前-人名			
ルートヴィヒ・ヴィトゲンシュタイン	名前-人名			
レーモン・ロエヴィ	名前-人名			
ロジェストヴェンスキー	名前-人名			
ロジャー・ニコルズ	名前-人名			
ロバート・ケネディ	名前-人名			
ヴァージニア・ウルフ	名前-人名			
上杉憲政	名前-人名			
中島義道	名前-人名			
中村光一	名前-人名			
中村哲也	名前-人名			
丹羽長秀	名前-人名			
乃木希典	名前-人名			
久夛良木健	名前-人名			
井上成美	名前-人名			
井上真樹夫	名前-人名			
佐藤二朗	名前-人名			
佐藤可士和	名前-人名			
佐藤康彦	名前-人名			
冨田勲	名前-人名			
出光元	名前-人名			
加藤寛治	名前-人名			
加藤敏	名前-人名			
北条氏康	名前-人名			
原研哉	名前-人名			
司馬遼太郎	名前-人名			
吉村昭	名前-人名			
在原業平	名前-人名			
坊上卓郎	名前-人名			
塚本慶一郎	名前-人名			
増山江威子	名前-人名			
大久保利通	名前-人名			
大塚明夫	名前-人名			
大石祐道	名前-人名			
大貫卓也	名前-人名			
大野雄二	名前-人名			
天野建	名前-人名			
天野祐吉	名前-人名			
奈良橋陽子	名前-人名			
奥寺健	名前-人名			
安倍晴明	名前-人名			
宮野隆	名前-人名			
寺澤寛一	名前-人名			
小林利充	名前-人名			
小林清志	名前-人名			
小池徹平	名前-人名			
小泉八雲	名前-人名			
小野利恵子	名前-人名			
尾崎穏通	名前-人名			
山下洋	名前-人名			
山本五十六	名前-人名			
山本権兵衛	名前-人名			
山県昌景	名前-人名			
岡田啓介	名前-人名			
岩崎博	名前-人名			
峰不二子	名前-人名			
川田敏寛	名前-人名			
平山智	名前-人名			
平田達治	名前-人名			
戸田誠之助	名前-人名			
新田次郎	名前-人名			
早川正士	名前-人名			
星亨	名前-人名			
星亮一	名前-人名			
星新一	名前-人名			
末次信正	名前-人名			
松井範雄	名前-人名			
松田聖子	名前-人名			
柏原寛司	名前-人名			
柳宗理	名前-人名			
栗田貫一	名前-人名			
森末慎二	名前-人名			
榊原清則	名前-人名			
次元大介	名前-人名			
武田信玄	名前-人名			
殿勝秀樹	名前-人名			
水木一郎	名前-人名			
水野晴郎	名前-人名			
池内紀	名前-人名			
池田勝	名前-人名			
淀川長治	名前-人名			
清水俊二	名前-人名			
清水敏彦	名前-人名			
渡辺正彦	名前-人名			
滝口順平	名前-人名			
猪股修二	名前-人名			
王仁	名前-人名			
生出寿	名前-人名			
相賀真理子	名前-人名			
真木洋三	名前-人名			
石川五ェ門	名前-人名			
石田太郎	名前-人名			
秋山仁	名前-人名			
秋山真之	名前-人名			
稲葉良道	名前-人名			
立木文彦	名前-人名			
米内光政	名前-人名			
粟津潔	名前-人名			
納谷悟朗	名前-人名			
緒方賢一	名前-人名			
葛西薫	名前-人名			
蒼井雄	名前-人名			
西尾幹二	名前-人名			
西郷隆盛	名前-人名			
鈴木清司	名前-人名			
銭形警部	名前-人名			
長野憲業	名前-人名			
長野業盛	名前-人名			
飯岡順一	名前-人名			
飯島澄男	名前-人名			
鬼束ちひろ	名前-人名			
鳥居一雄	名前-人名			
鶴渕允寿	名前-人名			
齊藤秀雄	名前-人名			
フリース	名前-製品名-衣服名			
兜	名前-製品名-衣服名			
天文学	名前-製品名-学問名			
無差別大量殺人行為を行った団体の規制に関する法律	名前-製品名-規則名			
破壊活動防止法	名前-製品名-規則名			
狼男	名前-製品名-キャラクター名			
銀星	名前-製品名-キャラクター名			
ボールルームダンス	名前-製品名-競技名			
スクリューボール・コメディ	名前-製品名-芸術名-映画名	固有名詞ではない		
スプラッター映画	名前-製品名-芸術名-映画名	固有名詞ではない		
スペクタクル映画	名前-製品名-芸術名-映画名	固有名詞ではない		
スラップスティック・コメディ映画	名前-製品名-芸術名-映画名	固有名詞ではない		
スリラー映画	名前-製品名-芸術名-映画名	固有名詞ではない		
3-D映画	名前-製品名-芸術名-映画名	固有名詞ではない		
B級映画	名前-製品名-芸術名-映画名	固有名詞ではない		
SF映画	名前-製品名-芸術名-映画名	固有名詞ではない		
ご当地映画	名前-製品名-芸術名-映画名	固有名詞ではない		
アニメ映画	名前-製品名-芸術名-映画名	固有名詞ではない		
アメリカン・ニューシネマ	名前-製品名-芸術名-映画名	固有名詞ではない		
アート・フィルム	名前-製品名-芸術名-映画名	固有名詞ではない		
カルト映画	名前-製品名-芸術名-映画名	固有名詞ではない		
カンフー映画	名前-製品名-芸術名-映画名	固有名詞ではない		
ギャング映画	名前-製品名-芸術名-映画名	固有名詞ではない		
ギャンブル映画	名前-製品名-芸術名-映画名	固有名詞ではない		
サイレント映画	名前-製品名-芸術名-映画名	固有名詞ではない		
サスペンス映画	名前-製品名-芸術名-映画名	固有名詞ではない		
アクション映画	名前-製品名-芸術名-映画名	固有名詞ではない		
テクニカラー映画	名前-製品名-芸術名-映画名	固有名詞ではない		
トーキー映画	名前-製品名-芸術名-映画名	固有名詞ではない		
ドキュメンタリー映画	名前-製品名-芸術名-映画名	固有名詞ではない		
ニュース映画	名前-製品名-芸術名-映画名	固有名詞ではない		
ニューロティック映画	名前-製品名-芸術名-映画名	固有名詞ではない		
パニック映画	名前-製品名-芸術名-映画名	固有名詞ではない		
ヒット曲映画化作品	名前-製品名-芸術名-映画名	固有名詞ではない		
ピカレスク・ロマン	名前-製品名-芸術名-映画名	固有名詞ではない		
ファミリー映画	名前-製品名-芸術名-映画名	固有名詞ではない		
ファンタジー映画	名前-製品名-芸術名-映画名	固有名詞ではない		
ホラー映画	名前-製品名-芸術名-映画名	固有名詞ではない		
ポルノ映画	名前-製品名-芸術名-映画名	固有名詞ではない		
マカロニ・ウェスタン	名前-製品名-芸術名-映画名	固有名詞ではない		
ミステリ映画	名前-製品名-芸術名-映画名	固有名詞ではない		
ミュージカル映画	名前-製品名-芸術名-映画名	固有名詞ではない		
モンド映画	名前-製品名-芸術名-映画名	固有名詞ではない		
ヤクザ映画	名前-製品名-芸術名-映画名	固有名詞ではない		
レスビアン・ゲイ映画	名前-製品名-芸術名-映画名	固有名詞ではない		
ロード・ムーヴィ	名前-製品名-芸術名-映画名	固有名詞ではない		
児童映画	名前-製品名-芸術名-映画名	固有名詞ではない		
動物映画	名前-製品名-芸術名-映画名	固有名詞ではない		
実験映画	名前-製品名-芸術名-映画名	固有名詞ではない		
宣伝映画	名前-製品名-芸術名-映画名	固有名詞ではない		
怪獣映画	名前-製品名-芸術名-映画名	固有名詞ではない		
恋愛映画	名前-製品名-芸術名-映画名	固有名詞ではない		
成人映画	名前-製品名-芸術名-映画名	固有名詞ではない		
戦争映画	名前-製品名-芸術名-映画名	固有名詞ではない		
探偵映画	名前-製品名-芸術名-映画名	固有名詞ではない		
教育映画	名前-製品名-芸術名-映画名	固有名詞ではない		
文芸映画	名前-製品名-芸術名-映画名	固有名詞ではない		
歴史映画	名前-製品名-芸術名-映画名	固有名詞ではない		
特撮映画	名前-製品名-芸術名-映画名	固有名詞ではない		
短編映画	名前-製品名-芸術名-映画名	固有名詞ではない		
社会派映画	名前-製品名-芸術名-映画名	固有名詞ではない		
記録映画	名前-製品名-芸術名-映画名	固有名詞ではない		
連続活劇	名前-製品名-芸術名-映画名	固有名詞ではない		
長編映画	名前-製品名-芸術名-映画名	固有名詞ではない		
青春映画	名前-製品名-芸術名-映画名	固有名詞ではない		
音楽映画	名前-製品名-芸術名-映画名	固有名詞ではない		
風刺映画	名前-製品名-芸術名-映画名	固有名詞ではない		
科学映画	名前-製品名-芸術名-映画名	固有名詞ではない		
ゲーム作品映画化作品	名前-製品名-芸術名-映画名	固有名詞ではない		
マンガ作品映画化作品	名前-製品名-芸術名-映画名	固有名詞ではない		
文学作品映画化作品	名前-製品名-芸術名-映画名	固有名詞ではない		
A.I.	名前-製品名-芸術名-映画名			
スター・ウォーズ エピソード1/ファントム・メナス	名前-製品名-芸術名-映画名			
スター・ウォーズ エピソード3/シスの復讐	名前-製品名-芸術名-映画名			
スター・ウォーズ エピソード6/ジェダイの帰還	名前-製品名-芸術名-映画名			
ビューティフル・マインド	名前-製品名-芸術名-映画名			
ロード・オブ・ザ・リング	名前-製品名-芸術名-映画名			
地獄の黙示録	名前-製品名-芸術名-映画名			
数量の比較	名前-製品名-芸術名-映画名			
アスタリスク	名前-製品名-芸術名-音楽名	?他に「約物のひとつで、星号、星印とも呼ばれる」とある		
スワンプ・ロック	名前-製品名-芸術名-音楽名	固有名詞ではない		
ソフト・ロック	名前-製品名-芸術名-音楽名	固有名詞ではない		
アニメソング	名前-製品名-芸術名-音楽名	固有名詞ではない		
ヘヴィメタル	名前-製品名-芸術名-音楽名	固有名詞ではない		
SOS	名前-製品名-芸術名-音楽名	名前-組織名-組織名_その他		
あなただけを〜Summer Heartbreak〜	名前-製品名-芸術名-音楽名			
地上の星	名前-製品名-芸術名-音楽名			
ウルトラマン	名前-製品名-芸術名-番組名	人名？キャラクター名？		
ウルトラマンタロウ	名前-製品名-芸術名-番組名	人名？キャラクター名？		
とっとこハム太郎	名前-製品名-芸術名-番組名	名前-製品名-出版物名-出版物名_その他		
The Nutty Radio Show 鬼玉	名前-製品名-芸術名-番組名			
てるてる家族	名前-製品名-芸術名-番組名			
オールナイトニッポンR スペシャルナイト	名前-製品名-芸術名-番組名			
オールナイトニッポンいいネ!	名前-製品名-芸術名-番組名			
世界ウルルン滞在記	名前-製品名-芸術名-番組名			
名探偵ホームズ	名前-製品名-芸術名-番組名			
森田一義アワー笑っていいとも!	名前-製品名-芸術名-番組名			
探偵小説	名前-製品名-芸術名-文学名	固有名詞ではない		
ハリー・ポッターと秘密の部屋	名前-製品名-芸術名-文学名	名前-製品名-芸術名-映画名		
ハリー・ポッターと賢者の石	名前-製品名-芸術名-文学名	名前-製品名-芸術名-映画名		
シャーロック・ホームズシリーズ	名前-製品名-芸術名-文学名			
ボヘミアの醜聞	名前-製品名-芸術名-文学名			
マザリンの宝石	名前-製品名-芸術名-文学名			
変身物語	名前-製品名-芸術名-文学名			
妖怪	名前-製品名-芸術名-文学名			
孤高の人	名前-製品名-芸術名-文学名			
最後の挨拶	名前-製品名-芸術名-文学名			
海軍条約文書事件	名前-製品名-芸術名-文学名			
空き家の冒険	名前-製品名-芸術名-文学名			
イギリス英語	名前-製品名-言語名			
エルフ語	名前-製品名-言語名			
クウェンヤ	名前-製品名-言語名			
空	名前-製品名-主義思想名	「数の単位で10の21乗」とある単位名？		
共産主義	名前-製品名-主義思想名			
陰陽道	名前-製品名-主義思想名			
同人誌	名前-製品名-出版物名-雑誌名	固有名詞ではない		
広告	名前-製品名-出版物名-雑誌名			
週刊Weekly漫画アクション	名前-製品名-出版物名-雑誌名			
NARUTO	名前-製品名-出版物名-出版物名_その他	名前-製品名-芸術名-番組名		
ホテル	名前-製品名-出版物名-出版物名_その他	名前-製品名-芸術名-番組名		
仮面ライダーシリーズ	名前-製品名-出版物名-出版物名_その他	名前-製品名-芸術名-番組名		
光とともに…	名前-製品名-出版物名-出版物名_その他	名前-製品名-芸術名-番組名		
八甲田山死の彷徨	名前-製品名-出版物名-出版物名_その他			
焼きたて!!ジャぱん	名前-製品名-出版物名-出版物名_その他			
公衆電話	名前-製品名-製品名_その他	固有名詞ではない		
地方債	名前-製品名-製品名_その他	固有名詞ではない		
PCゲーム	名前-製品名-製品名_その他	固有名詞ではない		
同窓会	名前-製品名-製品名_その他	名前-製品名-芸術名-番組名	他に「同じ学校を卒業した者によって設立される非営利団体」とある。組織名？	
花火	名前-製品名-製品名_その他			
Memories Off	名前-製品名-製品名_その他			
TAMA300	名前-製品名-製品名_その他			
アルミホイール	名前-製品名-製品名_その他			
カール・ツァイスレンズ	名前-製品名-製品名_その他			
スマートメディア	名前-製品名-製品名_その他			
信長の野望Online	名前-製品名-製品名_その他			
卵	名前-製品名-食べ物名	固有名詞ではない		
料理	名前-製品名-食べ物名	固有名詞ではない		
お好み焼き	名前-製品名-食べ物名			
キムチ	名前-製品名-食べ物名			
小麦粉	名前-製品名-食べ物名			
焼きイカ	名前-製品名-食べ物名			
肉じゃが	名前-製品名-食べ物名			
M4中戦車	名前-製品名-乗り物名-車名			
三菱・eK	名前-製品名-乗り物名-車名			
カヌー	名前-製品名-乗り物名-船名	固有名詞ではない		
潜水艇	名前-製品名-乗り物名-船名	固有名詞ではない		
護衛艦	名前-製品名-乗り物名-船名	固有名詞ではない		
ダンケルク級戦艦	名前-製品名-乗り物名-船名			
快速列車	名前-製品名-乗り物名-列車名	固有名詞ではない		
準急列車	名前-製品名-乗り物名-列車名	固有名詞ではない		
超特急	名前-製品名-乗り物名-列車名	固有名詞ではない		
国鉄C57形蒸気機関車	名前-製品名-乗り物名-列車名			
NBC兵器	名前-製品名-武器名			
弾道ミサイル	名前-製品名-武器名			
シオニズム	名前-製品名-文化名			
クロマトグラフィー	名前-製品名-方式制度名			
地方交付税	名前-製品名-方式制度名			
地方分権	名前-製品名-方式制度名			
地方税	名前-製品名-方式制度名			
多摩地区大学協定	名前-製品名-方式制度名			
カタカナ	名前-製品名-方式制度名			
レコードレーベル	名前-組織名-企業名	固有名詞ではない		
レコード会社	名前-組織名-企業名	固有名詞ではない		
持株会社	名前-組織名-企業名	固有名詞ではない		
普通銀行	名前-組織名-企業名	固有名詞ではない		
株式会社	名前-組織名-企業名	固有名詞ではない		
第二地方銀行	名前-組織名-企業名	固有名詞ではない		
地方銀行	名前-組織名-企業名	固有名詞ではない		
tvk	名前-組織名-企業名			
アルファレコード	名前-組織名-企業名			
カール・ツァイス社	名前-組織名-企業名			
ソース	名前-組織名-企業名			
タルボ (自動車メーカー)	名前-組織名-企業名			
チュンソフト	名前-組織名-企業名			
ツァイス・イコン	名前-組織名-企業名			
トムス・エンタテインメント	名前-組織名-企業名			
ポリグラム	名前-組織名-企業名			
中央公論新社	名前-組織名-企業名			
和歌山銀行	名前-組織名-企業名			
新潟日報事業社	名前-組織名-企業名			
日田バス	名前-組織名-企業名			
東海楽器	名前-組織名-企業名			
東邦出版社	名前-組織名-企業名			
白水社	名前-組織名-企業名			
福岡放送	名前-組織名-企業名			
紀陽ホールディングス	名前-組織名-企業名			
西鉄バス両筑	名前-組織名-企業名			
西鉄バス二日市	名前-組織名-企業名			
阪和電気鉄道	名前-組織名-企業名			
鳥影社	名前-組織名-企業名			
日本国有鉄道	名前-組織名-協会名			
映画翻訳家協会	名前-組織名-協会名			
太平洋クラブライオンズ	名前-組織名-競技グループ名			
東洋艦隊	名前-組織名-軍隊名	固有名詞ではない		
大日本帝国海軍	名前-組織名-軍隊名			
CIA	名前-組織名-政府組織名			
中央省庁	名前-組織名-政府組織名			
地方公共団体	名前-組織名-政府組織名			
警察	名前-組織名-政府組織名			
GLAY	名前-組織名-組織名_その他			
JAM Project	名前-組織名-組織名_その他			
WaT	名前-組織名-組織名_その他			
アニメタル	名前-組織名-組織名_その他			
イエロー・マジック・オーケストラ	名前-組織名-組織名_その他			
キャプテン&テニール	名前-組織名-組織名_その他			
スティックス	名前-組織名-組織名_その他			
タロット	名前-組織名-組織名_その他			
ディラード&クラーク	名前-組織名-組織名_その他			
バナナマン	名前-組織名-組織名_その他			
フライング・ブリトー・ブラザーズ	名前-組織名-組織名_その他			
札幌市交通局	名前-組織名-組織名_その他			
独立研究科	名前-組織名-組織名_その他			
艦隊派	名前-組織名-組織名_その他			
ザ・サンドパイパーズ	名前-組織名-組織名_その他			
ユダヤ系	名前-組織名-民族名			
アテナイ	名前-地名-GPE-GPE_その他			
ガリチア	名前-地名-GPE-GPE_その他			
仏領インドシナ	名前-地名-GPE-GPE_その他			
加賀国	名前-地名-GPE-GPE_その他			
鹿児島藩	名前-地名-GPE-GPE_その他			
朝鮮民主主義人民共和国	名前-地名-GPE-国名			
北松浦郡	名前-地名-GPE-群名			
宗像郡	名前-地名-GPE-群名			
小県郡	名前-地名-GPE-群名			
東臼杵郡	名前-地名-GPE-群名			
東茨城郡	名前-地名-GPE-群名			
葦北郡	名前-地名-GPE-群名			
首都	名前-地名-GPE-市区町村名	固有名詞ではない		
スター	名前-地名-GPE-市区町村名	名前-人名	名前-製品名-製品名_その他	
高松	名前-地名-GPE-市区町村名	名前-人名		
イェーナ	名前-地名-GPE-市区町村名			
ブロディ	名前-地名-GPE-市区町村名			
三原市	名前-地名-GPE-市区町村名			
三鷹市	名前-地名-GPE-市区町村名			
中津市	名前-地名-GPE-市区町村名			
今治市	名前-地名-GPE-市区町村名			
加賀市	名前-地名-GPE-市区町村名			
和歌山市	名前-地名-GPE-市区町村名			
大洲市	名前-地名-GPE-市区町村名			
宗像市	名前-地名-GPE-市区町村名			
小松市	名前-地名-GPE-市区町村名			
岩国市	名前-地名-GPE-市区町村名			
戸塚区	名前-地名-GPE-市区町村名			
横浜市	名前-地名-GPE-市区町村名			
水戸市	名前-地名-GPE-市区町村名			
江迎町	名前-地名-GPE-市区町村名			
津奈木町	名前-地名-GPE-市区町村名			
津屋崎町	名前-地名-GPE-市区町村名			
渋谷区	名前-地名-GPE-市区町村名			
白石区	名前-地名-GPE-市区町村名			
真田町	名前-地名-GPE-市区町村名			
福津市	名前-地名-GPE-市区町村名			
筑紫野市	名前-地名-GPE-市区町村名			
舞鶴市	名前-地名-GPE-市区町村名			
茨城町	名前-地名-GPE-市区町村名			
西宮市	名前-地名-GPE-市区町村名			
調布市	名前-地名-GPE-市区町村名			
ノモス	名前-地名-GPE-都道府県州名	固有名詞ではない		
アルナーチャル・プラデーシュ州	名前-地名-GPE-都道府県州名			
ベーカー街221B	名前-地名-アドレス-郵便住所			
エーヤワディー川	名前-地名-地形名-河川湖沼名			
片山津温泉	名前-地名-地形名-河川湖沼名			
白浜温泉	名前-地名-地形名-河川湖沼名			
アルカトラズ島	名前-地名-地形名-陸上地形名			
ラウリオン銀山	名前-地名-地形名-陸上地形名			
信濃地方	名前-地名-地名_その他			
月	名前-地名-天体名-惑星名			
認知症	名前-病気名			
仮想戦記	名前-製品名-芸術名-文学名	固有名詞ではない		
天授 (周)	時間表現-時間-時代表現			
天授 (日本)	時間表現-時間-時代表現			
10月	時間表現-時間-日付表現			
10月15日	時間表現-時間-日付表現			
11月1日	時間表現-時間-日付表現			
11月28日	時間表現-時間-日付表現			
11月29日	時間表現-時間-日付表現			
12月	時間表現-時間-日付表現			
12月11日	時間表現-時間-日付表現			
12月12日	時間表現-時間-日付表現			
12月26日	時間表現-時間-日付表現			
13世紀	時間表現-時間-日付表現			
1574年	時間表現-時間-日付表現			
1632年	時間表現-時間-日付表現			
1638年	時間表現-時間-日付表現			
1700年代	時間表現-時間-日付表現			
1796年	時間表現-時間-日付表現			
1800年	時間表現-時間-日付表現			
1816年	時間表現-時間-日付表現			
1854年	時間表現-時間-日付表現			
1863年	時間表現-時間-日付表現			
1869年	時間表現-時間-日付表現			
1875年	時間表現-時間-日付表現			
1880年	時間表現-時間-日付表現			
1900年	時間表現-時間-日付表現			
1931年	時間表現-時間-日付表現			
1961年	時間表現-時間-日付表現			
1965年	時間表現-時間-日付表現			
1986年	時間表現-時間-日付表現			
1月22日	時間表現-時間-日付表現			
1月23日	時間表現-時間-日付表現			
1月4日	時間表現-時間-日付表現			
1月9日	時間表現-時間-日付表現			
2月	時間表現-時間-日付表現			
2月8日	時間表現-時間-日付表現			
2月9日	時間表現-時間-日付表現			
3月	時間表現-時間-日付表現			
3月15日	時間表現-時間-日付表現			
3月28日	時間表現-時間-日付表現			
3月3日	時間表現-時間-日付表現			
4月	時間表現-時間-日付表現			
4月3日	時間表現-時間-日付表現			
4月5日	時間表現-時間-日付表現			
4月6日	時間表現-時間-日付表現			
5月	時間表現-時間-日付表現			
5月27日	時間表現-時間-日付表現			
5月28日	時間表現-時間-日付表現			
6月17日	時間表現-時間-日付表現			
6月22日	時間表現-時間-日付表現			
6月29日	時間表現-時間-日付表現			
766年	時間表現-時間-日付表現			
7月	時間表現-時間-日付表現			
7月11日	時間表現-時間-日付表現			
7月17日	時間表現-時間-日付表現			
7月9日	時間表現-時間-日付表現			
803年	時間表現-時間-日付表現			
8月10日	時間表現-時間-日付表現			
8月28日	時間表現-時間-日付表現			
9月26日	時間表現-時間-日付表現			
9月27日	時間表現-時間-日付表現			
9月8日	時間表現-時間-日付表現			
9月9日	時間表現-時間-日付表現			
木曜日	時間表現-時間-曜日表現			
世界一	数値表現-順位表現			
脱出速度	数値表現-寸法表現-速度			
ルーマニア革命	名前-イベント名-イベント名_その他			
平成の大合併	名前-イベント名-イベント名_その他			
G8	名前-イベント名-催し物名-会議名			
ビルダーバーグ会議	名前-イベント名-催し物名-会議名			
個人情報保護審議会	名前-イベント名-催し物名-会議名			
メキシコシティオリンピック	名前-イベント名-催し物名-大会名			
レッスル・マニア	名前-イベント名-催し物名-大会名			
お盆	名前-イベント名-催し物名-催し物名_その他			
クレーター	名前-神名	名前-地名-地形名-陸上地形名		
アマルテア	名前-神名	名前-地名-天体名-惑星名		
ニンフ	名前-神名			
札幌ターミナル	名前-施設名-GOE-駅名-停車所名			
三宮駅	名前-施設名-GOE-駅名-電車駅名			
南松本駅	名前-施設名-GOE-駅名-電車駅名			
土浦駅	名前-施設名-GOE-駅名-電車駅名			
浪岡駅	名前-施設名-GOE-駅名-電車駅名			
登戸駅	名前-施設名-GOE-駅名-電車駅名			
白金台駅	名前-施設名-GOE-駅名-電車駅名			
目黒駅	名前-施設名-GOE-駅名-電車駅名			
西高島平駅	名前-施設名-GOE-駅名-電車駅名			
赤羽岩淵駅	名前-施設名-GOE-駅名-電車駅名			
越後田沢駅	名前-施設名-GOE-駅名-電車駅名			
麻布十番駅	名前-施設名-GOE-駅名-電車駅名			
神戸港	名前-施設名-GOE-駅名-港名			
カリフォルニア大学バークレー校	名前-施設名-GOE-学校名			
テレビタレントセンター	名前-施設名-GOE-学校名			
組合立甲陵高等学校	名前-施設名-GOE-学校名			
長宝寺	名前-施設名-GOE-神社寺名			
宇高航路	名前-施設名-路線名-航路名			
水島臨海鉄道水島本線	名前-施設名-路線名-電車路線名			
国道117号	名前-施設名-路線名-道路名			
国道174号	名前-施設名-路線名-道路名			
国道294号	名前-施設名-路線名-道路名			
国道353号	名前-施設名-路線名-道路名			
国道408号	名前-施設名-路線名-道路名			
学園東大通り	名前-施設名-路線名-道路名			
西海橋	名前-施設名-路線名-橋名			
特急札滝線	名前-施設名-路線名-路線_その他			
特急札芦線	名前-施設名-路線名-路線_その他			
高速しんとつかわ号	名前-施設名-路線名-路線_その他			
高速るもい号	名前-施設名-路線名-路線_その他			
果実	名前-自然物名-生物名-植物部位名			
トウダイグサ科	名前-自然物名-生物名-植物名	固有名詞ではない		
ユリ	名前-自然物名-生物名-植物名	名前-人名	?他に「女の子同士の恋愛、またそれを扱った漫画、小説、アニメ等の作品ジャンル」とある	
スギ	名前-自然物名-生物名-植物名			
染色体	名前-自然物名-生物名-生物名_その他			
僧帽弁	名前-自然物名-生物名-動物部位名			
大動脈	名前-自然物名-生物名-動物部位名			
大動脈弁	名前-自然物名-生物名-動物部位名			
指紋	名前-自然物名-生物名-動物部位名			
水晶体	名前-自然物名-生物名-動物部位名			
う	名前-自然物名-生物名-動物名-脊椎動物-鳥類			
ウグイス	名前-自然物名-生物名-動物名-脊椎動物-鳥類			
人間	名前-自然物名-生物名-動物名-脊椎動物-哺乳類			
オオツヤクワガタ属	名前-自然物名-生物名-動物名-無脊椎動物-昆虫			
クワガタムシ科	名前-自然物名-生物名-動物名-無脊椎動物-昆虫			
カゲロウ	名前-自然物名-生物名-動物名-無脊椎動物-昆虫			
アメリカ合衆国国務長官	名前-称号名-地位名			
カリフ	名前-称号名-地位名			
CDE	名前-職業名			
プロレスラー	名前-職業名			
ガリレオ	名前-人名	名前-名前_その他	名前-製品名-方式制度名	名前-製品名-乗り物名-宇宙船名
きくち教児	名前-人名			
アメンホテプ4世	名前-人名			
ウィリアム・P・ロジャース	名前-人名			
エイブラハム・リンカーン	名前-人名			
エドワード・エマーソン・バーナード	名前-人名			
ギブアップ	名前-人名			
ギュスターヴ・フローベール	名前-人名			
クリスチャン・ハーター	名前-人名			
コーデル・ハル	名前-人名			
サージェント・スローター	名前-人名			
ザ・シーク	名前-人名			
ジョナサン・ラーソン	名前-人名			
ジョン・クーチ・アダムズ	名前-人名			
セルゲイ・ラフマニノフ	名前-人名			
トロワ・バートン	名前-人名			
ニコライ・ヴォルコフ	名前-人名			
ハルク・ホーガン	名前-人名			
ハールーン・アッ＝ラシード	名前-人名			
ビル・ジョイ	名前-人名			
フローラ・ハイマン	名前-人名			
ボブ・バックランド	名前-人名			
ヤフヤー・イブン＝ハーリド	名前-人名			
ヴォルテール	名前-人名			
上田耕一郎	名前-人名			
下平正一	名前-人名			
下野紘	名前-人名			
不破哲三	名前-人名			
中村正雄	名前-人名			
久本雅美	名前-人名			
二宮文造	名前-人名			
二瓶正也	名前-人名			
二谷英明	名前-人名			
井上小百合	名前-人名			
佐々木良作	名前-人名			
円谷英二	名前-人名			
北山愛郎	名前-人名			
南廣	名前-人名			
吉幾三	名前-人名			
向井長年	名前-人名			
和泉元彌	名前-人名			
国光	名前-人名			
坂上春子	名前-人名			
坂上氏	名前-人名			
坂上田村麻呂	名前-人名			
坂本太郎	名前-人名			
塚本三郎	名前-人名			
多田省吾	名前-人名			
多賀谷真稔	名前-人名			
大久保直彦	名前-人名			
大内啓伍	名前-人名			
大平正芳	名前-人名			
大柴滋夫	名前-人名			
天本英世	名前-人名			
安井道頓	名前-人名			
安倍晋太郎	名前-人名			
安生洋二	名前-人名			
安藤仁兵衛	名前-人名			
宮本顕治	名前-人名			
小平忠	名前-人名			
小林千穂	名前-人名			
小林正巳	名前-人名			
山中一希	名前-人名			
山口敏夫	名前-人名			
山口智充	名前-人名			
岡正芳	名前-人名			
岩田ちとせ	名前-人名			
岩間正男	名前-人名			
嵯峨天皇	名前-人名			
市川正一	名前-人名			
平城上皇	名前-人名			
徳永正利	名前-人名			
成安氏	名前-人名			
成田亨	名前-人名			
戸井康成	名前-人名			
政次夏希	名前-人名			
斉木しげる	名前-人名			
春日一幸	名前-人名			
本間勇輔	名前-人名			
杉山裕子	名前-人名			
松本善明	名前-人名			
柴田理恵	名前-人名			
桓武天皇	名前-人名			
森藤よしひろ	名前-人名			
楢崎弥之助	名前-人名			
横山まさみち	名前-人名			
正木良明	名前-人名			
武藤山治	名前-人名			
永末英一	名前-人名			
江田五月	名前-人名			
河野洋平	名前-人名			
浅井美幸	名前-人名			
浦沢義雄	名前-人名			
深谷里奈	名前-人名			
渡辺正行	名前-人名			
湯本貴宣	名前-人名			
瀬長亀次郎	名前-人名			
熊谷カズヒロ	名前-人名			
熊谷真菜	名前-人名			
田川誠一	名前-人名			
田英夫	名前-人名			
田邊誠	名前-人名			
真田信利	名前-人名			
真田信吉	名前-人名			
真田信政	名前-人名			
矢野絢也	名前-人名			
石ノ森章太郎	名前-人名			
石上大輔	名前-人名			
石井洋祐	名前-人名			
石原隆	名前-人名			
神取恭子	名前-人名			
福留功男	名前-人名			
竹入義勝	名前-人名			
竹田由紀	名前-人名			
糸井重里	名前-人名			
織田信長	名前-人名			
良忍	名前-人名			
若乃花幹士_(初代)	名前-人名			
西村英一	名前-人名			
西沢富夫	名前-人名			
酒井忠世	名前-人名			
野坂参三	名前-人名			
金丸信	名前-人名			
鈴木一弘	名前-人名			
鈴木善幸	名前-人名			
長江英和	名前-人名			
阿具根登	名前-人名			
阿部昭吾	名前-人名			
青山紀子	名前-人名			
飛鳥田一雄	名前-人名			
Β-ラクタム系抗生物質	名前-製品名-医薬品名			
占星術	名前-製品名-学問名			
マクロ経済	名前-製品名-学問名			
個人情報保護関連五法	名前-製品名-規則名			
情報公開・個人情報保護審査会設置法	名前-製品名-規則名			
日米相互防衛援助協定	名前-製品名-規則名			
通話表	名前-製品名-規則名			
雪国はつらつ条例	名前-製品名-規則名			
ケイロン	名前-製品名-キャラクター名			
ケンタウロス	名前-製品名-キャラクター名			
ポロス	名前-製品名-キャラクター名			
機巧奇傳ヒヲウ戦記	名前-製品名-芸術名-映画名			
ブラックメタル	名前-製品名-芸術名-音楽名	固有名詞ではない		
遙かなる時空の中で〜紫陽花ゆめ語り〜	名前-製品名-芸術名-芸術名_その他	名前-製品名-芸術名-番組名		
新機動戦記ガンダムW OPERATION METEOR	名前-製品名-芸術名-芸術名_その他			
遙かなる時空の中で2〜白き龍の神子〜	名前-製品名-芸術名-芸術名_その他			
青の奇跡	名前-製品名-芸術名-芸術名_その他			
ゴールデンタイム	名前-製品名-芸術名-番組名	?他に「テレビ業界で19時〜22時の時間帯を指す用語」とある		
テレビ番組	名前-製品名-芸術名-番組名	固有名詞ではない		
バラエティ番組	名前-製品名-芸術名-番組名	固有名詞ではない		
フレンズ	名前-製品名-芸術名-番組名	名前-製品名-芸術名-音楽名		
カレイドスター	名前-製品名-芸術名-番組名	名前-製品名-芸術名-芸術名_その他		
ストラトス・フォー	名前-製品名-芸術名-番組名	名前-製品名-芸術名-芸術名_その他		
キディグレイド	名前-製品名-芸術名-番組名	名前-製品名-芸術名-文学名		
カスミン	名前-製品名-芸術名-番組名	名前-製品名-芸術名-文学名		
ママはぽよぽよザウルスがお好き	名前-製品名-芸術名-番組名	名前-製品名-芸術名-文学名		
遙かなる時空の中で〜八葉抄〜	名前-製品名-芸術名-番組名	名前-製品名-芸術名-文学名	名前-製品名-製品名_その他	
ふしぎ星の☆ふたご姫	名前-製品名-芸術名-番組名			
G-onらいだーす	名前-製品名-芸術名-番組名			
HEY!HEY!HEY!	名前-製品名-芸術名-番組名			
Lips Party21.jp	名前-製品名-芸術名-番組名			
NG騎士ラムネ&40	名前-製品名-芸術名-番組名			
VOICE CREW	名前-製品名-芸術名-番組名			
おまかせスクラッパーズ	名前-製品名-芸術名-番組名			
ちっちゃな雪使いシュガー	名前-製品名-芸術名-番組名			
わがまま☆フェアリー ミルモでポン!	名前-製品名-芸術名-番組名			
カウボーイビバップ	名前-製品名-芸術名-番組名			
ダウンタウンのガキの使いやあらへんで!!	名前-製品名-芸術名-番組名			
ビバリーヒルズ高校白書	名前-製品名-芸術名-番組名			
ミュータント・タートルズ	名前-製品名-芸術名-番組名			
ヤンボウ ニンボウ トンボウ	名前-製品名-芸術名-番組名			
ユメみるハックスレー	名前-製品名-芸術名-番組名			
ロックマンエグゼ	名前-製品名-芸術名-番組名			
ロミオの青い空	名前-製品名-芸術名-番組名			
宇宙の騎士テッカマンブレード	名前-製品名-芸術名-番組名			
東映不思議コメディーシリーズ	名前-製品名-芸術名-番組名			
桂小米朝のハートフル大阪	名前-製品名-芸術名-番組名			
浜村淳の大阪夢散歩	名前-製品名-芸術名-番組名			
聖戦士ダンバイン	名前-製品名-芸術名-番組名			
英國戀物語エマ	名前-製品名-芸術名-番組名			
蒼き伝説シュート！	名前-製品名-芸術名-番組名			
超獣機神ダンクーガ	名前-製品名-芸術名-番組名			
魔境伝説アクロバンチ	名前-製品名-芸術名-番組名			
魔法少女ちゅうかないぱねま!	名前-製品名-芸術名-番組名			
魔法少女ちゅうかなぱいぱい!	名前-製品名-芸術名-番組名			
魔法少女リリカルなのは	名前-製品名-芸術名-番組名			
銀河英雄伝説	名前-製品名-芸術名-文学名	名前-製品名-芸術名-番組名	名前-製品名-製品名_その他	
ARIA	名前-製品名-芸術名-文学名	名前-製品名-芸術名-番組名	名前-製品名-乗り物名-車名	名前-製品名-製品名_その他
DANDOH!	名前-製品名-芸術名-文学名	名前-製品名-芸術名-番組名		
うしろの百太郎	名前-製品名-芸術名-文学名	名前-製品名-芸術名-番組名		
グレネーダー〜ほほえみの閃士〜	名前-製品名-芸術名-文学名	名前-製品名-芸術名-番組名		
ドラゴンボールZ	名前-製品名-芸術名-文学名	名前-製品名-芸術名-番組名		
南国少年パプワくん	名前-製品名-芸術名-文学名	名前-製品名-芸術名-番組名		
双恋	名前-製品名-芸術名-文学名	名前-製品名-芸術名-番組名	名前-製品名-製品名_その他	
双恋 -フタコイ-	名前-製品名-芸術名-文学名	名前-製品名-芸術名-番組名	名前-製品名-製品名_その他	
巨人の星	名前-製品名-芸術名-文学名	名前-製品名-芸術名-番組名		
幽★遊★白書	名前-製品名-芸術名-文学名	名前-製品名-芸術名-番組名		
犬夜叉	名前-製品名-芸術名-文学名	名前-製品名-芸術名-番組名	名前-製品名-キャラクター名	
魔法少女猫たると	名前-製品名-芸術名-文学名	名前-製品名-芸術名-番組名		
魍魎戦記MADARA	名前-製品名-芸術名-文学名	名前-製品名-芸術名-文学名	名前-製品名-製品名_その他	名前-製品名-芸術名-芸術名_その他
ギリシア神話	名前-製品名-芸術名-文学名			
スクラップド・プリンセス	名前-製品名-芸術名-文学名			
千夜一夜物語	名前-製品名-芸術名-文学名			
原獣文書	名前-製品名-芸術名-文学名			
HELLSING	名前-製品名-芸術名-文学名			
藍より青し	名前-製品名-芸術名-文学名			
風魔の小次郎	名前-製品名-芸術名-文学名			
キュビズム	名前-製品名-主義思想名	名前-製品名-文化名		
シュールレアリズム	名前-製品名-主義思想名	名前-製品名-文化名		
週刊少年サンデー	名前-製品名-出版物名-雑誌名			
経済政策	名前-製品名-政策計画名	固有名詞ではない		
DESIRE	名前-製品名-製品名_その他	名前-製品名-芸術名-音楽名		
To Heart	名前-製品名-製品名_その他	名前-製品名-芸術名-番組名		
金色のコルダ	名前-製品名-製品名_その他	名前-製品名-芸術名-文学名		
DivX	名前-製品名-製品名_その他			
"Java 2 Platform, Enterprise Edition"	名前-製品名-製品名_その他			
Melty Blood	名前-製品名-製品名_その他			
アカネマニアックス	名前-製品名-製品名_その他			
オフィススイート	名前-製品名-製品名_その他			
Solaris	名前-製品名-製品名_その他			
スーパーロボット大戦	名前-製品名-製品名_その他			
ゼルダの伝説 時のオカリナ	名前-製品名-製品名_その他			
テイルズオブレジェンディア	名前-製品名-製品名_その他			
パワードール	名前-製品名-製品名_その他			
ファイアーエムブレム	名前-製品名-製品名_その他			
ファンタスティックフォーチュン2	名前-製品名-製品名_その他			
ファントム・キングダム	名前-製品名-製品名_その他			
ファントム・ブレイブ	名前-製品名-製品名_その他			
ファーストKISS☆物語	名前-製品名-製品名_その他			
ラ・ピュセル 光の聖女伝説	名前-製品名-製品名_その他			
久遠の絆	名前-製品名-製品名_その他			
伝説のオウガバトル	名前-製品名-製品名_その他			
天外魔境	名前-製品名-製品名_その他			
戦国BASARA	名前-製品名-製品名_その他			
遙かなる時空の中で	名前-製品名-製品名_その他			
遙かなる時空の中で2	名前-製品名-製品名_その他			
遙かなる時空の中で3	名前-製品名-製品名_その他			
遙かなる時空の中で3・十六夜記	名前-製品名-製品名_その他			
遙かなる時空の中で〜盤上遊戯〜	名前-製品名-製品名_その他			
魔界戦記ディスガイア	名前-製品名-製品名_その他			
ジュース	名前-製品名-食べ物名	名前-人名	ジョナサン・ラーソン	名前-製品名-芸術名-音楽名
王林	名前-製品名-食べ物名	名前-人名		
カルヴァドス	名前-製品名-食べ物名	名前-地名-GPE-都道府県州名		
果汁	名前-製品名-食べ物名			
コーヒー	名前-製品名-食べ物名			
シードル	名前-製品名-食べ物名			
ジャム	名前-製品名-食べ物名			
アルプス乙女	名前-製品名-食べ物名			
ゴールデンデリシャス	名前-製品名-食べ物名			
デリシャス	名前-製品名-食べ物名			
水	名前-製品名-食べ物名			
牛乳	名前-製品名-食べ物名			
高速バス	名前-製品名-乗り物名-車名	固有名詞ではない		
路線バス	名前-製品名-乗り物名-車名	固有名詞ではない		
オーロラ号	名前-製品名-乗り物名-車名			
ポテトライナー	名前-製品名-乗り物名-車名			
高速はこだて号	名前-製品名-乗り物名-車名			
フェリー	名前-製品名-乗り物名-船名	固有名詞ではない		
小田急50000形電車	名前-製品名-乗り物名-列車名			
狩勝 (列車)	名前-製品名-乗り物名-列車名			
ローマ字	名前-製品名-方式制度名			
仮名	名前-製品名-方式制度名			
平仮名	名前-製品名-方式制度名			
歴史的仮名遣い	名前-製品名-方式制度名			
点字	名前-製品名-方式制度名			
片仮名	名前-製品名-方式制度名			
現代仮名遣い	名前-製品名-方式制度名			
WWE殿堂	名前-製品名-方式制度名			
カー・パリネロ法	名前-製品名-方式制度名			
分子動力学法	名前-製品名-方式制度名			
中央銀行	名前-組織名-企業名	固有名詞ではない		
地方公営企業	名前-組織名-企業名	固有名詞ではない		
相互銀行	名前-組織名-企業名	固有名詞ではない		
芸能プロダクション	名前-組織名-企業名	固有名詞ではない		
AT&T	名前-組織名-企業名			
Microsoft	名前-組織名-企業名			
アーツビジョン	名前-組織名-企業名			
エフエム愛知	名前-組織名-企業名			
シグマ・セブン	名前-組織名-企業名			
ジェイコム関東	名前-組織名-企業名			
テレビ大阪	名前-組織名-企業名			
円谷プロ	名前-組織名-企業名			
名古屋テレビ放送	名前-組織名-企業名			
宇高国道フェリー	名前-組織名-企業名			
弘南バス	名前-組織名-企業名			
東京地下鉄	名前-組織名-企業名			
東海ラジオ	名前-組織名-企業名			
根室交通	名前-組織名-企業名			
檜山観光バス	名前-組織名-企業名			
水島臨海鉄道	名前-組織名-企業名			
銀嶺バス	名前-組織名-企業名			
ロックフェラー財団	名前-組織名-協会名			
NWA	名前-組織名-競技グループ名	名前-組織名-組織名_その他	名前-組織名-企業名	
UWFインターナショナル	名前-組織名-競技グループ名			
WWE	名前-組織名-競技グループ名			
全日本プロレス	名前-組織名-競技グループ名			
新日本プロレス	名前-組織名-競技グループ名			
海上警備隊	名前-組織名-軍隊名			
無所属	名前-組織名-政党名			
アッバース朝	名前-組織名-政府組織名			
保安庁	名前-組織名-政府組織名			
国連局	名前-組織名-政府組織名			
開拓使	名前-組織名-政府組織名			
ダウンタウン	名前-組織名-組織名_その他	名前-製品名-芸術名-音楽名		
胴田貫	名前-組織名-組織名_その他	名前-製品名-武器名		
かつみ・さゆり	名前-組織名-組織名_その他			
バルマク家	名前-組織名-組織名_その他			
リズム	名前-組織名-組織名_その他			
リトル・ウィッチパルフェシリーズ	名前-組織名-組織名_その他			
印象派	名前-組織名-組織名_その他			
平野七名家	名前-組織名-組織名_その他			
平野氏	名前-組織名-組織名_その他			
末吉氏	名前-組織名-組織名_その他			
モーラ	名前-単位名-単位名_その他			
平方度	名前-単位名-単位名_その他			
ドラム	名前-単位名-通貨名	名前-単位名-単位名_その他		
上野国	名前-地名-GPE-GPE_その他			
摂津国	名前-地名-GPE-GPE_その他			
沼田藩	名前-地名-GPE-GPE_その他			
近江国	名前-地名-GPE-GPE_その他			
スリナム共和国	名前-地名-GPE-国名			
バシコルトスタン共和国	名前-地名-GPE-国名			
上水内郡	名前-地名-GPE-群名			
下益城郡	名前-地名-GPE-群名			
中魚沼郡	名前-地名-GPE-群名			
仙北郡	名前-地名-GPE-群名			
児玉郡	名前-地名-GPE-群名			
東頸城郡	名前-地名-GPE-群名			
海草郡	名前-地名-GPE-群名			
生駒郡	名前-地名-GPE-群名			
空知郡	名前-地名-GPE-群名			
道頓堀	名前-地名-GPE-市区町村名	名前-施設名-施設名_その他		
つがる	名前-地名-GPE-市区町村名	名前-製品名-乗り物名-列車名	名前-製品名-食べ物名	
つくば市	名前-地名-GPE-市区町村名			
アセンズ	名前-地名-GPE-市区町村名			
ルムニク・ヴルチャ	名前-地名-GPE-市区町村名			
三郷町	名前-地名-GPE-市区町村名			
世田谷区	名前-地名-GPE-市区町村名			
五所川原市	名前-地名-GPE-市区町村名			
伊王島町	名前-地名-GPE-市区町村名			
佐世保市	名前-地名-GPE-市区町村名			
佐賀市	名前-地名-GPE-市区町村名			
倉敷市	名前-地名-GPE-市区町村名			
北広島市	名前-地名-GPE-市区町村名			
北杜市	名前-地名-GPE-市区町村名			
十日町市	名前-地名-GPE-市区町村名			
占冠村	名前-地名-GPE-市区町村名			
厚真町	名前-地名-GPE-市区町村名			
土浦市	名前-地名-GPE-市区町村名			
塩沢町	名前-地名-GPE-市区町村名			
外海町	名前-地名-GPE-市区町村名			
多良見町	名前-地名-GPE-市区町村名			
富山市	名前-地名-GPE-市区町村名			
岩見沢市	名前-地名-GPE-市区町村名			
平野区	名前-地名-GPE-市区町村名			
弘前市	名前-地名-GPE-市区町村名			
新座市	名前-地名-GPE-市区町村名			
早来町	名前-地名-GPE-市区町村名			
時津町	名前-地名-GPE-市区町村名			
松之山町	名前-地名-GPE-市区町村名			
松代町	名前-地名-GPE-市区町村名			
松本市	名前-地名-GPE-市区町村名			
栗沢町	名前-地名-GPE-市区町村名			
江別市	名前-地名-GPE-市区町村名			
津南町	名前-地名-GPE-市区町村名			
滝川市	名前-地名-GPE-市区町村名			
琴海町	名前-地名-GPE-市区町村名			
琴の海市	名前-地名-GPE-市区町村名			
砂川市	名前-地名-GPE-市区町村名			
神戸市	名前-地名-GPE-市区町村名			
穂別町	名前-地名-GPE-市区町村名			
立科町	名前-地名-GPE-市区町村名			
箕郷町	名前-地名-GPE-市区町村名			
美唄市	名前-地名-GPE-市区町村名			
美郷町 (宮崎県)	名前-地名-GPE-市区町村名			
美郷町 (島根県)	名前-地名-GPE-市区町村名			
美郷町 (秋田県)	名前-地名-GPE-市区町村名			
美里町 (和歌山県)	名前-地名-GPE-市区町村名			
美里町 (埼玉県)	名前-地名-GPE-市区町村名			
美里町 (熊本県)	名前-地名-GPE-市区町村名			
苫小牧市	名前-地名-GPE-市区町村名			
茅野市	名前-地名-GPE-市区町村名			
西海市	名前-地名-GPE-市区町村名			
諫早市	名前-地名-GPE-市区町村名			
追分町	名前-地名-GPE-市区町村名			
野母崎町	名前-地名-GPE-市区町村名			
鎌倉市	名前-地名-GPE-市区町村名			
長与町	名前-地名-GPE-市区町村名			
長崎市	名前-地名-GPE-市区町村名			
飯綱町	名前-地名-GPE-市区町村名			
香焼町	名前-地名-GPE-市区町村名			
高松市	名前-地名-GPE-市区町村名			
鵡川町	名前-地名-GPE-市区町村名			
黒石市	名前-地名-GPE-市区町村名			
スヴェルドロフスク州	名前-地名-GPE-都道府県州名			
サントル地域圏	名前-地名-国内地域名			
三宮	名前-地名-国内地域名			
メソアメリカ	名前-地名-大陸地域名			
八ヶ岳連峰	名前-地名-地形名-陸上地形名			
針葉樹林	名前-地名-地形名-陸上地形名			
霧ヶ峰	名前-地名-地形名-陸上地形名			
水道	名前-地名-地名_その他			
カウス・メディア	名前-地名-天体名-恒星名			
散光星雲	名前-地名-天体名-天体名_その他	固有名詞ではない		
いて座矮小楕円銀河	名前-地名-天体名-天体名_その他			
オメガ星団	名前-地名-天体名-天体名_その他			
ブラックホール	名前-地名-天体名-天体名_その他			
南斗六星	名前-地名-天体名-天体名_その他			
干潟星雲	名前-地名-天体名-天体名_その他			
三裂星雲	名前-地名-天体名-天体名_その他			
ガリレオ衛星	名前-地名-天体名-惑星名			
PDA	名前-病気名	名前-製品名-製品名_その他	?他に「Power Distribution Assemblyの略」とある	
スペイン風邪	名前-病気名			
僧帽弁逸脱症	名前-病気名			
口蓋裂	名前-病気名			
大動脈解離	名前-病気名			
大動脈閉鎖不全症	名前-病気名			
気胸	名前-病気名			
結合組織病	名前-病気名			
五代十国時代	時間表現-時間-時代表現			
興国	時間表現-時間-時代表現			
10月16日	時間表現-時間-日付表現			
1180年	時間表現-時間-日付表現			
11月10日	時間表現-時間-日付表現			
11月13日	時間表現-時間-日付表現			
11月15日	時間表現-時間-日付表現			
11月19日	時間表現-時間-日付表現			
11月22日	時間表現-時間-日付表現			
11月27日	時間表現-時間-日付表現			
11月2日	時間表現-時間-日付表現			
11月9日	時間表現-時間-日付表現			
12月16日	時間表現-時間-日付表現			
12月24日	時間表現-時間-日付表現			
12月25日	時間表現-時間-日付表現			
12月7日	時間表現-時間-日付表現			
12月8日	時間表現-時間-日付表現			
1345年	時間表現-時間-日付表現			
1519年	時間表現-時間-日付表現			
1600年	時間表現-時間-日付表現			
1602年	時間表現-時間-日付表現			
1608年	時間表現-時間-日付表現			
1645年	時間表現-時間-日付表現			
1674年	時間表現-時間-日付表現			
1684年	時間表現-時間-日付表現			
1725年	時間表現-時間-日付表現			
1734年	時間表現-時間-日付表現			
1738年	時間表現-時間-日付表現			
1744年	時間表現-時間-日付表現			
1746年	時間表現-時間-日付表現			
1751年	時間表現-時間-日付表現			
1793年	時間表現-時間-日付表現			
1803年	時間表現-時間-日付表現			
1818年	時間表現-時間-日付表現			
1821年	時間表現-時間-日付表現			
1830年	時間表現-時間-日付表現			
1832年	時間表現-時間-日付表現			
1857年	時間表現-時間-日付表現			
1862年	時間表現-時間-日付表現			
1868年	時間表現-時間-日付表現			
1877年	時間表現-時間-日付表現			
1883年	時間表現-時間-日付表現			
1884年	時間表現-時間-日付表現			
1885年	時間表現-時間-日付表現			
1890年	時間表現-時間-日付表現			
1893年	時間表現-時間-日付表現			
1895年	時間表現-時間-日付表現			
1896年	時間表現-時間-日付表現			
1917年	時間表現-時間-日付表現			
1920年	時間表現-時間-日付表現			
1925年	時間表現-時間-日付表現			
1929年	時間表現-時間-日付表現			
1933年	時間表現-時間-日付表現			
1937年	時間表現-時間-日付表現			
1946年	時間表現-時間-日付表現			
1947年	時間表現-時間-日付表現			
1960年	時間表現-時間-日付表現			
1972年	時間表現-時間-日付表現			
1981年	時間表現-時間-日付表現			
19年	時間表現-時間-日付表現			
1月8日	時間表現-時間-日付表現			
30年	時間表現-時間-日付表現			
3月19日	時間表現-時間-日付表現			
4月2日	時間表現-時間-日付表現			
4月30日	時間表現-時間-日付表現			
5月1日	時間表現-時間-日付表現			
5月31日	時間表現-時間-日付表現			
5月4日	時間表現-時間-日付表現			
5月5日	時間表現-時間-日付表現			
5月7日	時間表現-時間-日付表現			
6月28日	時間表現-時間-日付表現			
737年	時間表現-時間-日付表現			
751年	時間表現-時間-日付表現			
758年	時間表現-時間-日付表現			
7月14日	時間表現-時間-日付表現			
7月16日	時間表現-時間-日付表現			
852年	時間表現-時間-日付表現			
912年	時間表現-時間-日付表現			
98年	時間表現-時間-日付表現			
9月17日	時間表現-時間-日付表現			
冬	時間表現-時間-日付表現			
平成19年	時間表現-時間-日付表現			
明治19年	時間表現-時間-日付表現			
昭和19年	時間表現-時間-日付表現			
昭和30年	時間表現-時間-日付表現			
昭和31年	時間表現-時間-日付表現			
昭和34年	時間表現-時間-日付表現			
昭和35年	時間表現-時間-日付表現			
昭和37年	時間表現-時間-日付表現			
昭和39年	時間表現-時間-日付表現			
昭和59年	時間表現-時間-日付表現			
紀元前19年	時間表現-時間-日付表現			
２００５年	時間表現-時間-日付表現			
40日抗争	名前-イベント名-イベント名_その他			
インフレ	名前-イベント名-イベント名_その他			
第8回参議院議員通常選挙	名前-イベント名-イベント名_その他			
自衛隊イラク派遣	名前-イベント名-イベント名_その他			
ハーグ事件	名前-イベント名-事故事件名			
国会議事堂放火事件	名前-イベント名-事故事件名			
80年戦争	名前-イベント名-戦争名			
イラク戦争	名前-イベント名-戦争名			
インドネシア独立戦争	名前-イベント名-戦争名			
ギリシャ独立戦争	名前-イベント名-戦争名			
希土戦争 (1897年)	名前-イベント名-戦争名			
希土戦争 (1919年-1922年)	名前-イベント名-戦争名			
ドラフト会議	名前-イベント名-催し物名-会議名			
ペンテコステ	名前-イベント名-催し物名-催し物名_その他	名前-製品名-芸術名-文学名		
復活祭	名前-イベント名-催し物名-催し物名_その他			
昇天祭	名前-イベント名-催し物名-催し物名_その他			
ペルセポネ	名前-神名			
マックス・プランク研究所	名前-施設名-GOE-GOE_その他			
日向高崎パーキングエリア	名前-施設名-GOE-駅名-停車所名			
浜松町バスターミナル	名前-施設名-GOE-駅名-停車所名			
国際展示場駅	名前-施設名-GOE-駅名-電車駅名			
夜明駅	名前-施設名-GOE-駅名-電車駅名			
大行司駅	名前-施設名-GOE-駅名-電車駅名			
彦山駅	名前-施設名-GOE-駅名-電車駅名			
新橋駅	名前-施設名-GOE-駅名-電車駅名			
日向前田駅	名前-施設名-GOE-駅名-電車駅名			
東高崎駅	名前-施設名-GOE-駅名-電車駅名			
汐留駅	名前-施設名-GOE-駅名-電車駅名			
添田駅	名前-施設名-GOE-駅名-電車駅名			
高崎新田駅	名前-施設名-GOE-駅名-電車駅名			
ユーロポート	名前-施設名-GOE-駅名-港名			
日の出桟橋	名前-施設名-GOE-駅名-港名			
竹芝桟橋	名前-施設名-GOE-駅名-港名			
バックネル大学	名前-施設名-GOE-学校名			
ラトガース大学	名前-施設名-GOE-学校名			
日本映画学校	名前-施設名-GOE-学校名			
私立滝川高等学校	名前-施設名-GOE-学校名			
長野県松本深志高等学校	名前-施設名-GOE-学校名			
香川県大手前中学校・高等学校	名前-施設名-GOE-学校名			
郵便局	名前-施設名-GOE-公共機関名	固有名詞ではない		
ルーヴル美術館	名前-施設名-GOE-美術博物館名			
松山城 (伊予国)	名前-施設名-記念碑名			
江戸城	名前-施設名-記念碑名			
芝離宮庭園	名前-施設名-公園名			
旧芝離宮恩賜庭園	名前-施設名-公園名			
東京モノレール羽田線	名前-施設名-路線名-電車路線名			
都営地下鉄浅草線	名前-施設名-路線名-電車路線名			
国道16号	名前-施設名-路線名-道路名			
国道1号	名前-施設名-路線名-道路名			
国道221号	名前-施設名-路線名-道路名			
国道246号	名前-施設名-路線名-道路名			
国道279号	名前-施設名-路線名-道路名			
国道466号	名前-施設名-路線名-道路名			
国道4号	名前-施設名-路線名-道路名			
奥州街道	名前-施設名-路線名-道路名			
尻手黒川道路	名前-施設名-路線名-道路名			
横浜市道環状2号	名前-施設名-路線名-道路名			
東京都道・神奈川県道3号世田谷町田線	名前-施設名-路線名-道路名			
神奈川県道12号横浜上麻生線	名前-施設名-路線名-道路名			
神奈川県道45号丸子中山茅ヶ崎線	名前-施設名-路線名-道路名			
神奈川県道・東京都道140号川崎町田線	名前-施設名-路線名-道路名			
神奈川県道・東京都道9号川崎府中線	名前-施設名-路線名-道路名			
第三京浜	名前-施設名-路線名-道路名			
原子核	名前-自然物名-自然物名_その他			
チューリップ	名前-自然物名-生物名-植物名			
ビーツ	名前-自然物名-生物名-植物名			
ホムンクルス	名前-自然物名-生物名-動物部位名	?他に「錬金術師によって作られる人工生命体」とある		
アメリカ合衆国大統領	名前-称号名-地位名			
厚生大臣	名前-称号名-地位名			
国家元首	名前-称号名-地位名			
国連事務総長	名前-称号名-地位名			
撃墜王	名前-称号名-地位名			
プロ野球選手	名前-職業名			
SF作家	名前-職業名			
オルガニスト	名前-職業名			
グラビアアイドル	名前-職業名			
シンセサイザー奏者	名前-職業名			
ジャーナリスト	名前-職業名			
スコアラー	名前-職業名			
スタントマン	名前-職業名			
ピアニスト	名前-職業名			
ファッションデザイナー	名前-職業名			
プロボクサー	名前-職業名			
マジシャン	名前-職業名			
写真家	名前-職業名			
劇作家	名前-職業名			
力士	名前-職業名			
化学者	名前-職業名			
博物学者	名前-職業名			
天文学者	名前-職業名			
女性アイドル	名前-職業名			
女性タレント	名前-職業名			
将棋棋士	名前-職業名			
官僚	名前-職業名			
小説家	名前-職業名			
指揮者	名前-職業名			
政治学者	名前-職業名			
教育学者	名前-職業名			
振付師	名前-職業名			
推理作家	名前-職業名			
映画プロデューサー	名前-職業名			
映画俳優	名前-職業名			
植物学者	名前-職業名			
歴史家	名前-職業名			
気象学者	名前-職業名			
法学者	名前-職業名			
洋画家	名前-職業名			
演歌歌手	名前-職業名			
物理学者	名前-職業名			
生物学者	名前-職業名			
科学者	名前-職業名			
編集者	名前-職業名			
男優	名前-職業名			
美術家	名前-職業名			
翻訳家	名前-職業名			
芸術家	名前-職業名			
詩人	名前-職業名			
陸上選手	名前-職業名			
革命家	名前-職業名			
音楽プロデューサー	名前-職業名			
ユリアナ女王	名前-人名	「ユリアナ」と「女王」に分ける？		
ボンズ	名前-人名	名前-組織名-企業名		
かとうかずこ	名前-人名			
ふかわりょう	名前-人名			
ふじいあきら	名前-人名			
アドルフ・ヒットラー	名前-人名			
アドルフ・ヒトラー	名前-人名			
アマレ・スタウダマイアー	名前-人名			
アラン・ドロン	名前-人名			
アルベルト・フジモリ	名前-人名			
アルヴァン・アダムス	名前-人名			
アレクサンダー・フォン・フンボルト	名前-人名			
アレグザンダー1世 (スコットランド王)	名前-人名			
アントニー・フォッカー	名前-人名			
アントン・ブルックナー	名前-人名			
アンネ・フランク	名前-人名			
アンファニー・ハーダウェイ	名前-人名			
ウィリアム・ブラックストン	名前-人名			
ウィリアム・ブレイク	名前-人名			
ウォルター・デイビス	名前-人名			
イリヤ・プリゴジン	名前-人名			
ウラジーミル・プーチン	名前-人名			
エドムント・フッサール	名前-人名			
エドワード・ヴァン・ヘイレン	名前-人名			
エドヴィン・フィッシャー	名前-人名			
エラスムス	名前-人名			
エリック・コマス	名前-人名			
エルナン・コルテス	名前-人名			
エルヴィス・プレスリー	名前-人名			
エンツォ・フェラーリ	名前-人名			
エンリコ・フェルミ	名前-人名			
エヴァ・ブラウン	名前-人名			
オソン1世	名前-人名			
オーランド・ブルーム	名前-人名			
カズオ・イシグロ	名前-人名			
カート・トーマス	名前-人名			
ガブリエル・フォーレ	名前-人名			
クラウディオス・プトレマイオス	名前-人名			
クリフォード・ブラウン	名前-人名			
ケビン・ジョンソン	名前-人名			
ゲオルク・フリードリヒ・プフタ	名前-人名			
ゲンナジー・ブルブリス	名前-人名			
コニー・ホーキンズ	名前-人名			
コンスタンティノス1世	名前-人名			
コンスタンティノス2世	名前-人名			
ゴットローブ・フレーゲ	名前-人名			
ゴットロープ・フレーゲ	名前-人名			
サトウ・ユウ	名前-人名			
サルヴァトーレ・フェラガモ	名前-人名			
ショーン・マリオン	名前-人名			
シント・ニコラス	名前-人名			
ジェフ・ブリッジス	名前-人名			
ジェフ・ホーナセック	名前-人名			
ジェブ・ブッシュ	名前-人名			
ジェリー・ブラッカイマー	名前-人名			
ジェーソン・キッド	名前-人名			
ジェームズ・M・ブキャナン	名前-人名			
ジェームズ・フレイザー	名前-人名			
ジェームズ・ブキャナン	名前-人名			
ジェームズ・ブライス	名前-人名			
ジェームズ・ブラッドリー	名前-人名			
ジェームズ・ブリッシュ	名前-人名			
ジェーン・フォンダ	名前-人名			
ジム・ジャクソン	名前-人名			
ジャック・ピエール・ブリッソー	名前-人名			
ジャン・アンリ・ファーブル	名前-人名			
ジャン・フレネル	名前-人名			
ジョゼフ・フーシェ	名前-人名			
ジョルジュ・ブラック	名前-人名			
ジョン・アーバスノット・フィッシャー	名前-人名			
ジョン・フィールド	名前-人名			
ジョン・フラムスティード	名前-人名			
ジョン・フランケンハイマー	名前-人名			
ジョージ・ウォーカー・ブッシュ	名前-人名			
ジョージ・フォアマン	名前-人名			
ジョー・フレージャー	名前-人名			
ジョー・プロスキ	名前-人名			
ジークムント・フロイト	名前-人名			
スティーブン・ハンター	名前-人名			
スティーブ・ナッシュ	名前-人名			
ステフォン・マーバリー	名前-人名			
ステーヴン・リード	名前-人名			
セルゲイ・ブブカ	名前-人名			
セルゲイ・プロコフィエフ	名前-人名			
セレスティン・フレネ	名前-人名			
ゼクス・マーキス	名前-人名			
ダン・マーリー	名前-人名			
チャールズ・バークレー	名前-人名			
ティコ・ブラーエ	名前-人名			
テリー・プラチェット	名前-人名			
ディック・バン・アースデール	名前-人名			
ディック・ブルーナ	名前-人名			
デイヴィッド・フォスター	名前-人名			
デイヴィッド・ブラウン	名前-人名			
デイヴィッド・ブリン	名前-人名			
デビッド・ブラバム	名前-人名			
トビー・フーパー	名前-人名			
トム・チェンバーズ	名前-人名			
トレーズ・クシュリナーダ	名前-人名			
ニコラス・ブルームバーゲン	名前-人名			
ニノ・ブルジャナゼ	名前-人名			
ニールセン	名前-人名			
ニール・ウォーク	名前-人名			
ネルヴァ	名前-人名			
ノルベルト・ブルグミュラー	名前-人名			
ノーマン・ロックウェル	名前-人名			
ハリソン・フォード	名前-人名			
ハンス・ベーテ	名前-人名			
バックミンスター・フラー	名前-人名			
バールーフ・デ・スピノザ	名前-人名			
パウロス1世	名前-人名			
ピエール・ド・フェルマー	名前-人名			
ピエール・ブーレーズ	名前-人名			
ピート・モンドリアン	名前-人名			
ファラ・ファーセット	名前-人名			
フィリップ・ホセ・ファーマー	名前-人名			
フィリッポス2世	名前-人名			
フランシス・フクヤマ	名前-人名			
フランシス・プーランク	名前-人名			
フランソワ1世 (フランス王)	名前-人名			
フランソワ2世 (フランス王)	名前-人名			
フリッツ・ラング	名前-人名			
フリーダ・カーロ	名前-人名			
フリーデンスライヒ・フンダートヴァッサー	名前-人名			
フレドリック・ブラウン	名前-人名			
フース・ヒディンク	名前-人名			
ブトロス・ブトロス＝ガーリ	名前-人名			
プチャーチン	名前-人名			
プラトン	名前-人名			
ヘルマン・ゲーリング	名前-人名			
ヘルマン・ロールシャッハ	名前-人名			
ヘルムート・フランケ	名前-人名			
ヘンリー・フォード	名前-人名			
ベルトルト・ブレヒト	名前-人名			
ベンジャミン・フランクリン	名前-人名			
ペドロ・デ・ラ・ロサ	名前-人名			
ポール・ウェストファル	名前-人名			
マイケル・J・フォックス	名前-人名			
マイケル・ファラデー	名前-人名			
マイケル・フィニスィー	名前-人名			
マウリッツ・エッシャー	名前-人名			
マリオン・ジマー・ブラッドリー	名前-人名			
マルセル・プルースト	名前-人名			
マーガレット・ミッチェル	名前-人名			
ミシェル・プラティニ	名前-人名			
ミッチー	名前-人名			
ミハエル・クルム	名前-人名			
モーガン・フリーマン	名前-人名			
ヤコブス・ヘンリクス・ファント・ホッフ	名前-人名			
ヤン・ファン・エイク	名前-人名			
ヨハネス・フェルメール	名前-人名			
ヨハネス・ブラームス	名前-人名			
ヨーゼフ・ゲッベルス	名前-人名			
ラジャ・ベル	名前-人名			
ラム・チェンイン	名前-人名			
ラーマ7世	名前-人名			
リアンドロ・バルボウサ	名前-人名			
リチャード・P・ファインマン	名前-人名			
リチャード・ローティ	名前-人名			
リヒャルト・フォン・ヴァイツゼッカー	名前-人名			
ルイ・オーギュスト・ブランキ	名前-人名			
ルイ・ブレリオ	名前-人名			
ルイ・ポナパルト	名前-人名			
ルドルフ・シュタイナー	名前-人名			
ルドルフ・ヘス	名前-人名			
レイ・ブラッドベリ	名前-人名			
ロバート・ジェームス・フィッシャー	名前-人名			
ロバート・ブラウン	名前-人名			
ロールズ	名前-人名			
ヴィリー・ブラント	名前-人名			
ヴィルヘルム・フルトヴェングラー	名前-人名			
ヴィルヘルム・レントゲン	名前-人名			
ヴェルナー・フォン・ブラウン	名前-人名			
ヴォルフガング・プライス	名前-人名			
ヴャチェスラフ・モロトフ	名前-人名			
三好絵梨香	名前-人名			
三津谷葉子	名前-人名			
上野千鶴子	名前-人名			
中山大三郎	名前-人名			
中島隆博	名前-人名			
中曽根康弘	名前-人名			
中村鋭一	名前-人名			
二上達也	名前-人名			
二間瀬敏史	名前-人名			
井上俊	名前-人名			
井上靖	名前-人名			
仰木彬	名前-人名			
伊東マンショ	名前-人名			
伊東正義	名前-人名			
伊東甲子太郎	名前-人名			
伊能忠敬	名前-人名			
佐々木修	名前-人名			
佐々木誠二	名前-人名			
佐藤健二	名前-人名			
佐藤栄作	名前-人名			
佐藤義則	名前-人名			
八木宏之	名前-人名			
内海賢二	名前-人名			
内田隆三	名前-人名			
冬季ねあ	名前-人名			
冬柴鐵三	名前-人名			
出川哲朗	名前-人名			
北村徳太郎	名前-人名			
千年屋俊幸	名前-人名			
古屋慶隆	名前-人名			
古川日出男	名前-人名			
古川登志夫	名前-人名			
古橋秀之	名前-人名			
古河裕之	名前-人名			
古田敦也	名前-人名			
古畑正秋	名前-人名			
古谷一行	名前-人名			
古谷徹	名前-人名			
古谷綱正	名前-人名			
司馬江漢	名前-人名			
吉井理人	名前-人名			
吉本真樹	名前-人名			
吉澤夏子	名前-人名			
吉見俊哉	名前-人名			
呂蒙	名前-人名			
和田知	名前-人名			
園田博之	名前-人名			
園田天光光	名前-人名			
坂口憲二	名前-人名			
大八木信行	名前-人名			
大友皇子	名前-人名			
光明皇后	名前-人名			
大中	名前-人名			
大島ミチル	名前-人名			
大川透	名前-人名			
大石大二郎	名前-人名			
大麻唯男	名前-人名			
夫差	名前-人名			
室園丈裕	名前-人名			
小山力也	名前-人名			
小幡栄	名前-人名			
小林康夫	名前-人名			
小林麻耶	名前-人名			
小栗了	名前-人名			
小栗旬	名前-人名			
小森陽一	名前-人名			
富士参號	名前-人名			
小野伸二	名前-人名			
小野和義	名前-人名			
尾高忠明	名前-人名			
山下和彦	名前-人名			
山中速人	名前-人名			
山口眞弓	名前-人名			
山本ひろ子	名前-人名			
山本吉宣	名前-人名			
山野哲也	名前-人名			
岡本伊三美	名前-人名			
岡沢憲芙	名前-人名			
岸本斉史	名前-人名			
岸野幸正	名前-人名			
川又千秋	名前-人名			
平林初之輔	名前-人名			
張五飛	名前-人名			
影山正彦	名前-人名			
影山正美	名前-人名			
徳川吉宗	名前-人名			
徳川家定	名前-人名			
徳川家康	名前-人名			
志村知幸	名前-人名			
斎藤邦吉	名前-人名			
斎賀みつき	名前-人名			
新田守男	名前-人名			
文天祥	名前-人名			
文帝 (漢)	名前-人名			
文帝 (隋)	名前-人名			
文月晃	名前-人名			
新島襄	名前-人名			
星野薫	名前-人名			
春日八郎	名前-人名			
昭和天皇	名前-人名			
時津海正博	名前-人名			
會川昇	名前-人名			
有田修三	名前-人名			
木下みつひろ	名前-人名			
本堂伊親	名前-人名			
本堂栄親	名前-人名			
本堂玄親	名前-人名			
本堂苗親	名前-人名			
本堂茂親	名前-人名			
本堂親久	名前-人名			
本堂親庸	名前-人名			
本堂親房	名前-人名			
本堂親道	名前-人名			
本堂豊親	名前-人名			
本山哲	名前-人名			
朱全忠	名前-人名			
村田英雄	名前-人名			
村田辰美	名前-人名			
松本保典	名前-人名			
松谷天光光	名前-人名			
柳田真孝	名前-人名			
柴田喜右衛門	名前-人名			
柴田秀勝	名前-人名			
根谷美智子	名前-人名			
桑島法子	名前-人名			
梨田昌孝	名前-人名			
森田美由紀	名前-人名			
武則天	名前-人名			
文醜	名前-人名			
武帝	名前-人名			
毛利聡子	名前-人名			
水島精二	名前-人名			
水樹奈々	名前-人名			
永井均	名前-人名			
永友聖也	名前-人名			
江原正士	名前-人名			
江崎真澄	名前-人名			
沢井美優	名前-人名			
河本英夫	名前-人名			
河野一郎	名前-人名			
津嘉山正種	名前-人名			
津田匠子	名前-人名			
淡海三船	名前-人名			
深井英五	名前-人名			
深作欣二	名前-人名			
深堀骨	名前-人名			
深津絵里	名前-人名			
深見じゅん	名前-人名			
源義経	名前-人名			
源頼朝	名前-人名			
瀬戸口藤吉	名前-人名			
猪口孝	名前-人名			
田島穂奈美	名前-人名			
田嶋淳子	名前-人名			
白鳥哲	名前-人名			
石塚運昇	名前-人名			
石橋義三	名前-人名			
福井威夫	名前-人名			
福井康雄	名前-人名			
福井謙二	名前-人名			
福家俊一	名前-人名			
福山英朗	名前-人名			
福山雅治	名前-人名			
福岡政行	名前-人名			
福島正実	名前-人名			
福島瑞穂	名前-人名			
福島菊次郎	名前-人名			
福本伸行	名前-人名			
福永健司	名前-人名			
福永正明	名前-人名			
福永武彦	名前-人名			
福江純	名前-人名			
福沢一郎	名前-人名			
福澤朗	名前-人名			
福田充徳	名前-人名			
福田康夫	名前-人名			
福田歓一	名前-人名			
福田沙紀	名前-人名			
福田赳夫	名前-人名			
福留孝介	名前-人名			
福盛和男	名前-人名			
立川祐路	名前-人名			
立花貞俶	名前-人名			
立花鑑通	名前-人名			
竹内浩典	名前-人名			
箕作祥一	名前-人名			
細川たかし	名前-人名			
織戸学	名前-人名			
聖武天皇	名前-人名			
脇阪寿一	名前-人名			
舘信吾	名前-人名			
舞井武依	名前-人名			
船橋洋一	名前-人名			
船田中	名前-人名			
船田元	名前-人名			
芙苑晶	名前-人名			
若林直美	名前-人名			
荒川弘	名前-人名			
藤井フミヤ	名前-人名			
藤井旭	名前-人名			
藤原ひとみ	名前-人名			
藤原カムイ	名前-人名			
藤原保信	名前-人名			
藤原啓治	名前-人名			
藤原惺窩	名前-人名			
藤原竜也	名前-人名			
藤原紀香	名前-人名			
藤原芳秀	名前-人名			
藤圭子	名前-人名			
藤城清治	名前-人名			
藤子不二雄A	名前-人名			
藤山一郎	名前-人名			
藤岡信勝	名前-人名			
藤岡弘、	名前-人名			
藤岡琢也	名前-人名			
藤岡麻美	名前-人名			
藤島康介	名前-人名			
藤崎奈々子	名前-人名			
藤崎慎吾	名前-人名			
藤崎竜	名前-人名			
藤木直人	名前-人名			
藤本美貴	名前-人名			
藤村俊二	名前-人名			
藤村富美男	名前-人名			
藤村文彦	名前-人名			
藤沢とおる	名前-人名			
藤沢周平	名前-人名			
藤田元司	名前-人名			
藤田和日郎	名前-人名			
藤田哲也	名前-人名			
藤田田	名前-人名			
藤田省三	名前-人名			
藤田良雄	名前-人名			
藤臣柊子	名前-人名			
藤谷しおり	名前-人名			
藤谷美紀	名前-人名			
藤谷舞	名前-人名			
藤野美奈子	名前-人名			
西本幸雄	名前-人名			
見田宗介	名前-人名			
諸葛亮	名前-人名			
豊口めぐみ	名前-人名			
道上龍	名前-人名			
重信房子	名前-人名			
野沢那智	名前-人名			
金子勝	名前-人名			
金子誠	名前-人名			
釘宮理恵	名前-人名			
鈴木三樹三郎	名前-人名			
鈴木啓示	名前-人名			
鈴木康二朗	名前-人名			
鈴木恵一	名前-人名			
関羽	名前-人名			
阿波野秀幸	名前-人名			
青木孝行	名前-人名			
風我明	名前-人名			
飯田章	名前-人名			
馮道	名前-人名			
駒田健吾	名前-人名			
高宮俊介	名前-人名			
高崎一郎	名前-人名			
高戸靖広	名前-人名			
高木真一	名前-人名			
高橋掬太郎	名前-人名			
高野貴裕	名前-人名			
麻生美代子	名前-人名			
アメリカ文学	名前-製品名-学問名			
日本の上代文学史	名前-製品名-学問名			
ウェストファリア条約	名前-製品名-規則名			
ローザンヌ条約	名前-製品名-規則名			
ワイマール憲法	名前-製品名-規則名			
日中平和友好条約	名前-製品名-規則名			
日本国との平和条約	名前-製品名-規則名			
郡区町村編制法	名前-製品名-規則名			
スキージャンプ	名前-製品名-競技名			
モータースポーツ	名前-製品名-競技名			
女子サッカー	名前-製品名-競技名			
イノセンス	名前-製品名-芸術名-映画名			
神に選ばれし無敵の男	名前-製品名-芸術名-映画名			
東村山音頭	名前-製品名-芸術名-音楽名			
軍艦マーチ	名前-製品名-芸術名-音楽名			
TXNニュースアイ	名前-製品名-芸術名-番組名			
ちいさなおばけアッチコッチソッチ	名前-製品名-芸術名-番組名			
レディス4	名前-製品名-芸術名-番組名			
全国歌謡ベストテン	名前-製品名-芸術名-番組名			
小さな巨人ミクロマン	名前-製品名-芸術名-番組名			
株式ニュース	名前-製品名-芸術名-番組名			
満点!しあわせテレビ	名前-製品名-芸術名-番組名			
激走!GT	名前-製品名-芸術名-番組名			
超時空世紀オーガス	名前-製品名-芸術名-番組名			
超時空要塞マクロス	名前-製品名-芸術名-番組名			
絢爛舞踏祭 ザ・マーズ・デイブレイク	名前-製品名-芸術名-番組名			
正義論	名前-製品名-芸術名-文学名	?他に「規範政治理論の研究分野の一つ」と「法哲学における問題領域の一つ」とある。		
丸出だめ夫	名前-製品名-芸術名-文学名	名前-人名		
あたしンち	名前-製品名-芸術名-文学名	名前-製品名-芸術名-番組名		
まほらば	名前-製品名-芸術名-文学名	名前-製品名-芸術名-番組名		
鋼の錬金術師	名前-製品名-芸術名-文学名	名前-製品名-芸術名-番組名		
魔法先生ネギま!	名前-製品名-芸術名-文学名	名前-製品名-芸術名-番組名	名前-製品名-芸術名-芸術名_その他	
三国志平話	名前-製品名-芸術名-文学名			
古事類苑	名前-製品名-芸術名-文学名			
続日本紀	名前-製品名-芸術名-文学名			
エン女医あきら先生	名前-製品名-芸術名-文学名			
古アテナイ方言	名前-製品名-言語名			
オカルト	名前-製品名-主義思想名			
ビッグコミックスピリッツ	名前-製品名-出版物名-雑誌名			
少年ビッグコミック	名前-製品名-出版物名-雑誌名			
月刊少年ガンガン	名前-製品名-出版物名-雑誌名			
小説中公	名前-製品名-出版物名-雑誌名			
ペン/フォークナー賞	名前-製品名-賞名			
全米図書賞	名前-製品名-賞名			
最優秀救援投手	名前-製品名-賞名			
最多勝	名前-製品名-賞名			
最高勝率	名前-製品名-賞名			
オランダの麻薬対策	名前-製品名-政策計画名			
鎖国	名前-製品名-政策計画名			
スライダー	名前-製品名-製品名_その他	固有名詞ではない		
チェス	名前-製品名-製品名_その他	固有名詞ではない		
ロールプレイングゲーム	名前-製品名-製品名_その他	固有名詞ではない		
BLUE BRAKER	名前-製品名-製品名_その他	名前-製品名-芸術名-芸術名_その他		
パズルアリーナ闘神伝	名前-製品名-製品名_その他	名前-製品名-芸術名-芸術名_その他		
闘神伝	名前-製品名-製品名_その他	名前-製品名-芸術名-芸術名_その他		
Suica	名前-製品名-製品名_その他			
にとうしんでん	名前-製品名-製品名_その他			
ディフェンダー	名前-製品名-製品名_その他			
ネオジオバトルコロシアム	名前-製品名-製品名_その他			
パスネット	名前-製品名-製品名_その他			
闘神伝2	名前-製品名-製品名_その他			
闘神伝3	名前-製品名-製品名_その他			
闘神伝カードクエスト	名前-製品名-製品名_その他			
ロシア料理	名前-製品名-食べ物名	固有名詞ではない		
米	名前-製品名-食べ物名	名前-自然物名-生物名-植物名		
ベーコン	名前-製品名-食べ物名	名前-人名		
エダムチーズ	名前-製品名-食べ物名			
カレーライス	名前-製品名-食べ物名			
キャビア	名前-製品名-食べ物名			
コンブ	名前-製品名-食べ物名			
ゴーダチーズ	名前-製品名-食べ物名			
サワークリーム	名前-製品名-食べ物名			
ソーセージ	名前-製品名-食べ物名			
チーズ	名前-製品名-食べ物名			
天スタ	名前-製品名-食べ物名			
牛肉	名前-製品名-食べ物名			
鶏肉	名前-製品名-食べ物名			
B-29	名前-製品名-乗り物名-飛行機名			
九六式艦上戦闘機	名前-製品名-乗り物名-飛行機名			
烈風	名前-製品名-乗り物名-飛行機名			
零式艦上戦闘機	名前-製品名-乗り物名-飛行機名			
震電	名前-製品名-乗り物名-飛行機名			
水上バス	名前-製品名-乗り物名-船名	固有名詞ではない		
海上バス	名前-製品名-乗り物名-船名	固有名詞ではない		
インドミタブル	名前-製品名-乗り物名-船名			
天城	名前-製品名-乗り物名-船名			
モビルスーツ	名前-製品名-武器名	「「ガンダムシリーズ」に登場する架空の兵器の分類の一つ」とある		
ビームサーベル	名前-製品名-武器名			
原子爆弾	名前-製品名-武器名			
ウイングガンダム	名前-製品名-武器名			
ウイングガンダムゼロ	名前-製品名-武器名			
ガンダムエピオン	名前-製品名-武器名			
ガンダムヘビーアームズ	名前-製品名-武器名			
シェンロンガンダム	名前-製品名-武器名			
リーオー	名前-製品名-武器名			
原爆	名前-製品名-武器名			
風船爆弾	名前-製品名-武器名			
ヘレニズム	名前-製品名-文化名			
テルミット法	名前-製品名-方式制度名			
二院制	名前-製品名-方式制度名			
ユリウス暦	名前-製品名-方式制度名			
共和制	名前-製品名-方式制度名			
国民投票	名前-製品名-方式制度名			
強制栽培制度	名前-製品名-方式制度名			
王制	名前-製品名-方式制度名			
配給制度	名前-製品名-方式制度名			
TBS	名前-組織名-企業名	?他に「韓国の道路交通情報を専門に扱うＦＭラジオネットワークの名称」とある		
JFEスチール	名前-組織名-企業名			
ウーファー	名前-組織名-企業名			
スクウェアエニックス	名前-組織名-企業名			
フォッカー社	名前-組織名-企業名			
ペイ・パー・ビュー・ジャパン	名前-組織名-企業名			
マセキ芸能社	名前-組織名-企業名			
メッサーシュミット社	名前-組織名-企業名			
ロケット	名前-組織名-企業名			
下北交通	名前-組織名-企業名			
下北信用金庫	名前-組織名-企業名			
中央公論社	名前-組織名-企業名			
勁草書房	名前-組織名-企業名			
宮崎交通	名前-組織名-企業名			
新曜社	名前-組織名-企業名			
新書館	名前-組織名-企業名			
春秋社	名前-組織名-企業名			
朝日出版社	名前-組織名-企業名			
日本貨物鉄道	名前-組織名-企業名			
日販	名前-組織名-企業名			
筑摩書房	名前-組織名-企業名			
紀伊国屋書店	名前-組織名-企業名			
関東自動車	名前-組織名-企業名			
青二プロダクション	名前-組織名-企業名			
青土社	名前-組織名-企業名			
青弓社	名前-組織名-企業名			
横浜市営バス	名前-組織名-企業名			
都営バス	名前-組織名-企業名			
NHK	名前-組織名-協会名			
アメリカ芸術文学アカデミー	名前-組織名-協会名			
トゥーレ協会	名前-組織名-協会名			
日本放送出版協会	名前-組織名-協会名			
JFL	名前-組織名-競技グループ名	名前-組織名-組織名_その他		
オリックス・バファローズ	名前-組織名-競技グループ名			
フェイエノールト	名前-組織名-競技グループ名			
フーフト・クラッセ	名前-組織名-競技グループ名			
中国社会人リーグ	名前-組織名-競技グループ名			
北海道日本ハムファイターズ	名前-組織名-競技グループ名			
阪急ブレーブス	名前-組織名-競技グループ名			
突撃隊	名前-組織名-軍隊名			
国連安全保障理事会	名前-組織名-国際組織名			
国際がん研究機関	名前-組織名-国際組織名			
オランダ人	名前-組織名-国籍名			
ギリシャ人	名前-組織名-国籍名			
労農党	名前-組織名-政党名			
国家社会主義ドイツ労働者党	名前-組織名-政党名			
呉	名前-組織名-政府組織名	名前-人名	名前-地名-GPE-市区町村名	
漢	名前-組織名-政府組織名	名前-組織名-民族名		
宋	名前-組織名-政府組織名	名前-地名-GPE-国名	名前-人名	
チャクリー王朝	名前-組織名-政府組織名			
前漢	名前-組織名-政府組織名			
北朝	名前-組織名-政府組織名			
南宋	名前-組織名-政府組織名			
周	名前-組織名-政府組織名			
後梁	名前-組織名-政府組織名			
後漢	名前-組織名-政府組織名			
徳川幕府	名前-組織名-政府組織名			
江戸幕府	名前-組織名-政府組織名			
隋	名前-組織名-政府組織名			
近江朝	名前-組織名-政府組織名			
シャンバラ	名前-組織名-組織名_その他	名前-製品名-芸術名-音楽名	?他に「チベットに伝わる理想の仏教国」とある。地名？国名？	ほかに「地底の国アガルタの首都」とある。地名？市区町村名？
佐竹氏	名前-組織名-組織名_その他			
藤原氏	名前-組織名-組織名_その他			
本堂氏	名前-組織名-組織名_その他			
19 (音楽グループ) 	名前-組織名-組織名_その他			
HOP CLUB	名前-組織名-組織名_その他			
L'Arc〜en〜Ciel	名前-組織名-組織名_その他			
アニプレックス	名前-組織名-組織名_その他			
グリュックスブルク家	名前-組織名-組織名_その他			
チュートリアル	名前-組織名-組織名_その他			
ヴィッテルスバッハ家	名前-組織名-組織名_その他			
京学派	名前-組織名-組織名_その他			
劇団岸野組	名前-組織名-組織名_その他			
医学部	名前-組織名-組織名_その他			
御陵衛士	名前-組織名-組織名_その他			
新撰組	名前-組織名-組織名_その他			
森派	名前-組織名-組織名_その他			
挙党体制連絡協議会	名前-組織名-組織名_その他			
教育学部	名前-組織名-組織名_その他			
美勇伝	名前-組織名-組織名_その他			
美少女クラブ31	名前-組織名-組織名_その他			
神宮司庁	名前-組織名-組織名_その他			
遣唐使	名前-組織名-組織名_その他			
ユダヤ人	名前-組織名-民族名			
ロマ	名前-組織名-民族名			
フント	名前-単位名-単位名_その他	名前-人名		
ワット	名前-単位名-単位名_その他			
町	名前-単位名-単位名_その他			
アルバ	名前-地名-GPE-GPE_その他			
オランダ領東インド	名前-地名-GPE-GPE_その他			
出羽国	名前-地名-GPE-GPE_その他			
常陸国	名前-地名-GPE-GPE_その他			
柳河藩	名前-地名-GPE-GPE_その他			
筑後国	名前-地名-GPE-GPE_その他			
紀伊藩	名前-地名-GPE-GPE_その他			
豊前国	名前-地名-GPE-GPE_その他			
豊後国	名前-地名-GPE-GPE_その他			
駿河国	名前-地名-GPE-GPE_その他			
東インド	名前-地名-GPE-GPE_その他			
タイ王国	名前-地名-GPE-国名			
デンマーク王国	名前-地名-GPE-国名			
バイエルン王国	名前-地名-GPE-国名			
バタヴィア共和国	名前-地名-GPE-国名			
バチカン市国	名前-地名-GPE-国名			
ブリヤート共和国	名前-地名-GPE-国名			
マケドニア王国	名前-地名-GPE-国名			
ヴァイマル共和国	名前-地名-GPE-国名			
古代ギリシア	名前-地名-GPE-国名			
大日本帝国	名前-地名-GPE-国名			
下北郡	名前-地名-GPE-群名			
下都賀郡	名前-地名-GPE-群名			
北諸県郡	名前-地名-GPE-群名			
大沼郡	名前-地名-GPE-群名			
宇和郡	名前-地名-GPE-群名			
耶麻郡	名前-地名-GPE-群名			
西諸県郡	名前-地名-GPE-群名			
テッサロニキ	名前-地名-GPE-市区町村名	名前-地名-GPE-都道府県州名		
さいたま市	名前-地名-GPE-市区町村名			
むつ市	名前-地名-GPE-市区町村名			
アイントホーフェン	名前-地名-GPE-市区町村名			
アーネム	名前-地名-GPE-市区町村名			
エンスヘーデ	名前-地名-GPE-市区町村名			
ケルクラーデ	名前-地名-GPE-市区町村名			
スヘルトーヘンボス（デン・ボッシュ）	名前-地名-GPE-市区町村名			
ズウォレ	名前-地名-GPE-市区町村名			
ティルブルフ	名前-地名-GPE-市区町村名			
テノチティトラン	名前-地名-GPE-市区町村名			
デルフト	名前-地名-GPE-市区町村名			
ナイメーヘン	名前-地名-GPE-市区町村名			
ミデルブルフ	名前-地名-GPE-市区町村名			
レリスタット	名前-地名-GPE-市区町村名			
上磯町	名前-地名-GPE-市区町村名			
中野区	名前-地名-GPE-市区町村名			
京都市	名前-地名-GPE-市区町村名			
仙台市	名前-地名-GPE-市区町村名			
会津坂下町	名前-地名-GPE-市区町村名			
住吉区	名前-地名-GPE-市区町村名			
保土ヶ谷区	名前-地名-GPE-市区町村名			
函館市	名前-地名-GPE-市区町村名			
千葉市	名前-地名-GPE-市区町村名			
名古屋市	名前-地名-GPE-市区町村名			
城東区	名前-地名-GPE-市区町村名			
塩川町	名前-地名-GPE-市区町村名			
墨田区	名前-地名-GPE-市区町村名			
多摩区	名前-地名-GPE-市区町村名			
大間町	名前-地名-GPE-市区町村名			
守口市	名前-地名-GPE-市区町村名			
宮前区	名前-地名-GPE-市区町村名			
小倉北区	名前-地名-GPE-市区町村名			
小林市	名前-地名-GPE-市区町村名			
山之口町	名前-地名-GPE-市区町村名			
岡山市	名前-地名-GPE-市区町村名			
川崎市	名前-地名-GPE-市区町村名			
広島市	名前-地名-GPE-市区町村名			
愛南町	名前-地名-GPE-市区町村名			
東成区	名前-地名-GPE-市区町村名			
東神楽町	名前-地名-GPE-市区町村名			
板橋区	名前-地名-GPE-市区町村名			
柳津町	名前-地名-GPE-市区町村名			
椴法華村	名前-地名-GPE-市区町村名			
武蔵野市	名前-地名-GPE-市区町村名			
水俣市	名前-地名-GPE-市区町村名			
河東町	名前-地名-GPE-市区町村名			
港北区	名前-地名-GPE-市区町村名			
湯川村	名前-地名-GPE-市区町村名			
狛江市	名前-地名-GPE-市区町村名			
目黒区	名前-地名-GPE-市区町村名			
相模原市	名前-地名-GPE-市区町村名			
石橋町	名前-地名-GPE-市区町村名			
福岡市	名前-地名-GPE-市区町村名			
神奈川区	名前-地名-GPE-市区町村名			
臼杵市	名前-地名-GPE-市区町村名			
荒川区	名前-地名-GPE-市区町村名			
蕨市	名前-地名-GPE-市区町村名			
西会津町	名前-地名-GPE-市区町村名			
西成区	名前-地名-GPE-市区町村名			
西東京市	名前-地名-GPE-市区町村名			
豊中市	名前-地名-GPE-市区町村名			
豊島区	名前-地名-GPE-市区町村名			
都城市	名前-地名-GPE-市区町村名			
都筑区	名前-地名-GPE-市区町村名			
野尻町	名前-地名-GPE-市区町村名			
阿倍野区	名前-地名-GPE-市区町村名			
静岡市	名前-地名-GPE-市区町村名			
館林市	名前-地名-GPE-市区町村名			
高原町	名前-地名-GPE-市区町村名			
高城町	名前-地名-GPE-市区町村名			
高郷村	名前-地名-GPE-市区町村名			
オーファーアイセル州	名前-地名-GPE-都道府県州名			
ゼーラント州	名前-地名-GPE-都道府県州名			
フレヴォラント州	名前-地名-GPE-都道府県州名			
ヘルダーラント州	名前-地名-GPE-都道府県州名			
リンブルグ州	名前-地名-GPE-都道府県州名			
北ブラバント州	名前-地名-GPE-都道府県州名			
イピロス	名前-地名-国内地域名			
カラガ地方	名前-地名-国内地域名			
ダバオ地方	名前-地名-国内地域名			
テッサリア	名前-地名-国内地域名			
シベリア連邦管区	名前-地名-国内地域名			
蝦夷地	名前-地名-国内地域名			
オランダ海上帝国	名前-地名-大陸地域名			
トラキア	名前-地名-大陸地域名			
ベネルクス3国	名前-地名-大陸地域名			
ベネルクス三国	名前-地名-大陸地域名			
中央ヨーロッパ	名前-地名-大陸地域名			
古代湖	名前-地名-地形名-河川湖沼名	固有名詞ではない		
アグサン川	名前-地名-地形名-河川湖沼名			
タゴ川	名前-地名-地形名-河川湖沼名			
マイニット湖	名前-地名-地形名-河川湖沼名			
下風呂温泉	名前-地名-地形名-河川湖沼名			
イオニア諸島	名前-地名-地形名-陸上地形名			
カルパチア山脈	名前-地名-地形名-陸上地形名			
下北半島	名前-地名-地形名-陸上地形名			
恐山山地	名前-地名-地形名-陸上地形名			
雷電	名前-地名-地名_その他	名前-製品名-乗り物名-飛行機名	名前-製品名-製品名_その他	名前-製品名-芸術名-音楽名
高原インターチェンジ	名前-地名-地名_その他			
飛鳥	名前-地名-地名_その他			
天平感宝	時間表現-時間-時代表現			
11月23日	時間表現-時間-日付表現			
11月5日	時間表現-時間-日付表現			
12月13日	時間表現-時間-日付表現			
12月23日	時間表現-時間-日付表現			
12月9日	時間表現-時間-日付表現			
1583年	時間表現-時間-日付表現			
1586年	時間表現-時間-日付表現			
1595年	時間表現-時間-日付表現			
1596年	時間表現-時間-日付表現			
1614年	時間表現-時間-日付表現			
1709年	時間表現-時間-日付表現			
1726年	時間表現-時間-日付表現			
1735年	時間表現-時間-日付表現			
1859年	時間表現-時間-日付表現			
1881年	時間表現-時間-日付表現			
1980年代	時間表現-時間-日付表現			
2月15日	時間表現-時間-日付表現			
2月18日	時間表現-時間-日付表現			
2月19日	時間表現-時間-日付表現			
3月18日	時間表現-時間-日付表現			
3月23日	時間表現-時間-日付表現			
4月26日	時間表現-時間-日付表現			
5月10日	時間表現-時間-日付表現			
6月4日	時間表現-時間-日付表現			
701年	時間表現-時間-日付表現			
714年	時間表現-時間-日付表現			
724年	時間表現-時間-日付表現			
727年	時間表現-時間-日付表現			
728年	時間表現-時間-日付表現			
729年	時間表現-時間-日付表現			
740年	時間表現-時間-日付表現			
741年	時間表現-時間-日付表現			
743年	時間表現-時間-日付表現			
744年	時間表現-時間-日付表現			
749年	時間表現-時間-日付表現			
752年	時間表現-時間-日付表現			
754年	時間表現-時間-日付表現			
756年	時間表現-時間-日付表現			
7月13日	時間表現-時間-日付表現			
7月15日	時間表現-時間-日付表現			
7月18日	時間表現-時間-日付表現			
8月8日	時間表現-時間-日付表現			
9月	時間表現-時間-日付表現			
9月29日	時間表現-時間-日付表現			
9月3日	時間表現-時間-日付表現			
紀元前2世紀	時間表現-時間-日付表現			
火曜日	時間表現-時間-曜日表現			
学徒出陣	名前-イベント名-イベント名_その他			
安保闘争	名前-イベント名-イベント名_その他			
東京大空襲	名前-イベント名-イベント名_その他			
極東国際軍事裁判	名前-イベント名-イベント名_その他			
極東軍事裁判	名前-イベント名-イベント名_その他			
終戦	名前-イベント名-イベント名_その他			
2.26事件	名前-イベント名-事故事件名			
JR福知山線脱線事故	名前-イベント名-事故事件名			
アメリカ同時多発テロ事件	名前-イベント名-事故事件名			
新潟県中越地震	名前-イベント名-自然災害名			
国民体育大会	名前-イベント名-催し物名-大会名			
春の高校バレー	名前-イベント名-催し物名-大会名			
愛知万博	名前-イベント名-催し物名-催し物名_その他			
大日如来	名前-神名			
盧舎那仏	名前-神名			
本店	名前-施設名-GOE-GOE_その他	固有名詞ではない		
癌研究所	名前-施設名-GOE-GOE_その他	固有名詞ではない		
三ヶ根駅	名前-施設名-GOE-駅名-電車駅名			
三木里駅	名前-施設名-GOE-駅名-電車駅名			
三河三谷駅	名前-施設名-GOE-駅名-電車駅名			
三河塩津駅	名前-施設名-GOE-駅名-電車駅名			
三河大塚駅	名前-施設名-GOE-駅名-電車駅名			
三河安城駅	名前-施設名-GOE-駅名-電車駅名			
串本駅	名前-施設名-GOE-駅名-電車駅名			
二川駅	名前-施設名-GOE-駅名-電車駅名			
京王八王子駅	名前-施設名-GOE-駅名-電車駅名			
安城駅	名前-施設名-GOE-駅名-電車駅名			
尾頭橋駅	名前-施設名-GOE-駅名-電車駅名			
弁天島駅	名前-施設名-GOE-駅名-電車駅名			
彦根駅	名前-施設名-GOE-駅名-電車駅名			
愛知御津駅	名前-施設名-GOE-駅名-電車駅名			
新鹿駅	名前-施設名-GOE-駅名-電車駅名			
東刈谷駅	名前-施設名-GOE-駅名-電車駅名			
江住駅	名前-施設名-GOE-駅名-電車駅名			
湯谷温泉駅	名前-施設名-GOE-駅名-電車駅名			
箕島駅	名前-施設名-GOE-駅名-電車駅名			
紀和駅	名前-施設名-GOE-駅名-電車駅名			
舞阪駅	名前-施設名-GOE-駅名-電車駅名			
蒲郡駅	名前-施設名-GOE-駅名-電車駅名			
西小坂井駅	名前-施設名-GOE-駅名-電車駅名			
西岡崎駅	名前-施設名-GOE-駅名-電車駅名			
西焼津駅	名前-施設名-GOE-駅名-電車駅名			
豊田町駅	名前-施設名-GOE-駅名-電車駅名			
近江八幡駅	名前-施設名-GOE-駅名-電車駅名			
近江長岡駅	名前-施設名-GOE-駅名-電車駅名			
逢妻駅	名前-施設名-GOE-駅名-電車駅名			
醒ヶ井駅	名前-施設名-GOE-駅名-電車駅名			
長瀞駅	名前-施設名-GOE-駅名-電車駅名			
高塚駅	名前-施設名-GOE-駅名-電車駅名			
鶴舞駅	名前-施設名-GOE-駅名-電車駅名			
法科大学院	名前-施設名-GOE-学校名	固有名詞ではない		
アリゾナ大学	名前-施設名-GOE-学校名			
ハーヴァード大学	名前-施設名-GOE-学校名			
ミュンヘン大学	名前-施設名-GOE-学校名			
北海道帝国大学	名前-施設名-GOE-学校名			
春日部共栄高校	名前-施設名-GOE-学校名			
東京女子医大	名前-施設名-GOE-学校名			
東京帝国大学	名前-施設名-GOE-学校名			
国分寺	名前-施設名-GOE-神社寺名			
俵美術館	名前-施設名-GOE-美術博物館名			
大坂城	名前-施設名-記念碑名			
神郷亀塚古墳	名前-施設名-記念碑名			
可児公園	名前-施設名-公園名			
名城公園	名前-施設名-公園名			
名古屋市営地下鉄名城線	名前-施設名-路線名-電車路線名			
国道307号	名前-施設名-路線名-道路名			
国道42号	名前-施設名-路線名-道路名			
第二名神高速道路	名前-施設名-路線名-道路名			
長野県道13号岡谷停車場線	名前-施設名-路線名-道路名			
長野県道16号岡谷茅野線	名前-施設名-路線名-道路名			
長野県道254号楢川岡谷線	名前-施設名-路線名-道路名			
エンジュ	名前-自然物名-生物名-植物名			
真核生物	名前-自然物名-生物名-生物名_その他	固有名詞ではない		
高度好塩菌	名前-自然物名-生物名-生物名_その他	固有名詞ではない		
古細菌	名前-自然物名-生物名-生物名_その他	固有名詞ではない		
好熱菌	名前-自然物名-生物名-生物名_その他	固有名詞ではない		
メタン菌	名前-自然物名-生物名-生物名_その他			
生体膜	名前-自然物名-生物名-生物名_その他			
オセロット	名前-自然物名-生物名-動物名-脊椎動物-哺乳類			
グリセロール	名前-自然物名-物質名			
チーフプロデューサー	名前-称号名-地位名			
下士官	名前-称号名-地位名			
予備自衛官	名前-称号名-地位名			
兵	名前-称号名-地位名			
医学博士	名前-称号名-地位名			
即応予備自衛官	名前-称号名-地位名			
太上天皇	名前-称号名-地位名			
将補	名前-称号名-地位名			
巡査部長	名前-称号名-地位名			
海上幕僚長	名前-称号名-地位名			
裁判長	名前-称号名-地位名			
郷士	名前-称号名-地位名			
防衛庁長官	名前-称号名-地位名			
陸上幕僚長	名前-称号名-地位名			
コメディアン	名前-職業名			
レースクイーン	名前-職業名			
ローカルタレント	名前-職業名			
外科医	名前-職業名			
民法学者	名前-職業名			
自衛官	名前-職業名			
サンディアゴ	名前-人名	名前-製品名-乗り物名-船名		
いかりや長介	名前-人名			
すほうれいこ	名前-人名			
やしきたかじん	名前-人名			
やまだ哲太	名前-人名			
ゆうゆ	名前-人名			
アグネス・チャン	名前-人名			
アルトゥーロ・トスカニーニ	名前-人名			
アーロン・コープランド	名前-人名			
ウィリアム・F・ウエップ	名前-人名			
カール・ポパー	名前-人名			
ケント・ギルバート	名前-人名			
コーディー	名前-人名			
サミュエル・バーバー	名前-人名			
ジェフ・バーグランド	名前-人名			
ジョセフ・B・キーナン	名前-人名			
ソクラテス	名前-人名			
ダグラス・マッカーサー	名前-人名			
パット・ギャレット	名前-人名			
パンチ佐藤	名前-人名			
ヒロコ・グレース	名前-人名			
ビリー・ジョエル	名前-人名			
マイケル・オンダーチェ	名前-人名			
ユンソナ	名前-人名			
ラダ・ビノード・パール	名前-人名			
ロマン・ロラン	名前-人名			
一青窈	名前-人名			
三木のり平	名前-人名			
三浦豪太	名前-人名			
三浦雄一郎	名前-人名			
三船敏郎	名前-人名			
下森定	名前-人名			
不破内親王	名前-人名			
中山仁	名前-人名			
中村彩花	名前-人名			
中村雅俊	名前-人名			
中田譲治	名前-人名			
中谷花子	名前-人名			
丹阿弥谷津子	名前-人名			
井ノ原快彦	名前-人名			
井上内親王	名前-人名			
井上正彦	名前-人名			
井上達夫	名前-人名			
井野碩哉	名前-人名			
仲村トオル	名前-人名			
伊豫田静弘	名前-人名			
似鳥利行	名前-人名			
佐戸井けん太	名前-人名			
佐藤幹夫	名前-人名			
佐藤翼	名前-人名			
佐藤隆太	名前-人名			
伝教大師	名前-人名			
元明天皇	名前-人名			
元正天皇	名前-人名			
光仁天皇	名前-人名			
児玉清	名前-人名			
内田康夫	名前-人名			
前沢迪雄	名前-人名			
加藤正俊	名前-人名			
吉岡美穂	名前-人名			
吉川圭三	名前-人名			
団藤重光	名前-人名			
埴谷雄高	名前-人名			
基王	名前-人名			
堀田正峯	名前-人名			
堀田正賓	名前-人名			
堀田正高	名前-人名			
堤大二郎	名前-人名			
塩沢とき	名前-人名			
多岐川裕美	名前-人名			
大原麗子	名前-人名			
大屋哲男	名前-人名			
大岩賞介	名前-人名			
大川周明	名前-人名			
大仏	名前-人名			
大木実	名前-人名			
大竹しのぶ	名前-人名			
孝謙天皇	名前-人名			
安原顕	名前-人名			
安積親王	名前-人名			
安達元一	名前-人名			
宮川彬良	名前-人名			
寺島健	名前-人名			
小園安名	名前-人名			
小堀陽貴	名前-人名			
小林武	名前-人名			
小林直樹	名前-人名			
小林秀雄	名前-人名			
小林雅英	名前-人名			
尾高朝雄	名前-人名			
山内明	名前-人名			
山岡三子	名前-人名			
山崎豊子	名前-人名			
山本武	名前-人名			
山田博行	名前-人名			
山田吾一	名前-人名			
岡敬純	名前-人名			
岡田二三	名前-人名			
岡田映一	名前-人名			
岡部要一	名前-人名			
岸信介	名前-人名			
嶋津格	名前-人名			
嶋田繁太郎	名前-人名			
川谷拓三	名前-人名			
川部修詩	名前-人名			
工藤静香	名前-人名			
市川森一	名前-人名			
平泉成	名前-人名			
平野元	名前-人名			
平野長勝	名前-人名			
平野長政	名前-人名			
平野長暁	名前-人名			
平野長泰	名前-人名			
平野長純	名前-人名			
平野長興	名前-人名			
平野長英	名前-人名			
平野長裕	名前-人名			
平野長里	名前-人名			
広田弘毅	名前-人名			
戸田恵子	名前-人名			
所ジョージ	名前-人名			
手塚理美	名前-人名			
文武天皇	名前-人名			
斎藤実	名前-人名			
斎藤英雄	名前-人名			
星野ちあき	名前-人名			
星野直樹	名前-人名			
最澄	名前-人名			
有馬昌彦	名前-人名			
朝加真由美	名前-人名			
木村兵太郎	名前-人名			
杉山元	名前-人名			
杉山清貴	名前-人名			
村上佑二	名前-人名			
東条英機	名前-人名			
東郷茂徳	名前-人名			
松井洋介	名前-人名			
松尾伝蔵	名前-人名			
松尾芭蕉	名前-人名			
松岡孝治	名前-人名			
松嶋菜々子	名前-人名			
松平保久	名前-人名			
松平健	名前-人名			
板谷由夏	名前-人名			
林光	名前-人名			
林泰文	名前-人名			
柏原芳恵	名前-人名			
柳生博	名前-人名			
柳田豊	名前-人名			
柴田恭兵	名前-人名			
慧能	名前-人名			
栗原安秀	名前-人名			
桂木隆夫	名前-人名			
梅原幹	名前-人名			
梅田みか	名前-人名			
森村進	名前-人名			
森迫永依	名前-人名			
森際康友	名前-人名			
樋井明日香	名前-人名			
橋本欣五郎	名前-人名			
橘諸兄	名前-人名			
武内文平	名前-人名			
武藤章	名前-人名			
水谷豊	名前-人名			
永射保	名前-人名			
永野修身	名前-人名			
永野護	名前-人名			
沢村一樹	名前-人名			
沢田知可子	名前-人名			
沢田研二	名前-人名			
泉ピン子	名前-人名			
津島恵子	名前-人名			
清水直行	名前-人名			
渡辺俊介	名前-人名			
渡辺謙	名前-人名			
渡辺錠太郎	名前-人名			
渥美国泰	名前-人名			
濱田俊也	名前-人名			
片岡義男	名前-人名			
片平晋作	名前-人名			
田中明夫	名前-人名			
田中貴志	名前-人名			
田島照	名前-人名			
白井貴子	名前-人名			
県犬養広刀自	名前-人名			
真地勇志	名前-人名			
真璃子	名前-人名			
矢崎滋	名前-人名			
石丸博也	名前-人名			
石井明美	名前-人名			
福原秀雄	名前-人名			
福島正則	名前-人名			
稲川善一	名前-人名			
竹内まりや	名前-人名			
築地博	名前-人名			
篠田三郎	名前-人名			
綿引勝彦	名前-人名			
聖武皇帝	名前-人名			
芦屋小雁	名前-人名			
芦屋雁之助	名前-人名			
茶川一郎	名前-人名			
荒木貞夫	名前-人名			
菅原禄弥	名前-人名			
菊池均也	名前-人名			
藤原不比等	名前-人名			
藤原仲麻呂	名前-人名			
藤原広嗣	名前-人名			
西田敏行	名前-人名			
観月ありさ	名前-人名			
豊臣秀吉	名前-人名			
豊臣秀頼	名前-人名			
賀屋興宣	名前-人名			
近藤晋	名前-人名			
道元	名前-人名			
道木伸隆	名前-人名			
都築浩	名前-人名			
酒井敏也	名前-人名			
酒井法子	名前-人名			
野村克也	名前-人名			
鈴木昭生	名前-人名			
鈴木貞一	名前-人名			
鈴木貫太郎	名前-人名			
鑑真	名前-人名			
長尾龍一	名前-人名			
長屋王	名前-人名			
阿南健治	名前-人名			
香取俊介	名前-人名			
高山右近	名前-人名			
高林由紀子	名前-人名			
高橋真梨子	名前-人名			
高橋美紀	名前-人名			
鶴岡一人	名前-人名			
鶴田浩二	名前-人名			
ウェディングドレス	名前-製品名-衣服名			
パキシル	名前-製品名-医薬品名			
麻酔科	名前-製品名-学問名			
テロ対策特別措置法	名前-製品名-規則名			
ローマ法	名前-製品名-規則名			
墾田永年私財法	名前-製品名-規則名			
日本国憲法第9条	名前-製品名-規則名			
自衛隊法	名前-製品名-規則名			
なんだろう	名前-製品名-キャラクター名			
モーグル	名前-製品名-競技名			
空手道	名前-製品名-競技名			
ジュブナイル	名前-製品名-芸術名-映画名	名前-製品名-芸術名-文学名	固有名詞ではない	
NIN×NIN 忍者ハットリくん THE MOVIE	名前-製品名-芸術名-映画名			
ゴジラ2000 ミレニアム	名前-製品名-芸術名-映画名			
ゴジラvsキングギドラ	名前-製品名-芸術名-映画名			
ゴジラvsスペースゴジラ	名前-製品名-芸術名-映画名			
ゴジラvsデストロイア	名前-製品名-芸術名-映画名			
ゴジラvsビオランテ	名前-製品名-芸術名-映画名			
ゴジラvsメカゴジラ	名前-製品名-芸術名-映画名			
ゴジラvsモスラ	名前-製品名-芸術名-映画名			
ゴジラ×メカゴジラ	名前-製品名-芸術名-映画名			
ゴジラ×メガギラス G消滅作戦	名前-製品名-芸術名-映画名			
ゴジラ×モスラ×メカゴジラ 東京SOS	名前-製品名-芸術名-映画名			
ゴジラ・モスラ・キングギドラ 大怪獣総攻撃	名前-製品名-芸術名-映画名			
スパイ・ゾルゲ	名前-製品名-芸術名-映画名			
リターナー	名前-製品名-芸術名-映画名			
戦国自衛隊1549	名前-製品名-芸術名-映画名			
サントラ	名前-製品名-芸術名-音楽名	固有名詞ではない		
交響曲	名前-製品名-芸術名-音楽名	固有名詞ではない		
ピアノ三重奏	名前-製品名-芸術名-音楽名	固有名詞ではない		
室内楽	名前-製品名-芸術名-音楽名	固有名詞ではない		
弦楽四重奏曲	名前-製品名-芸術名-音楽名	固有名詞ではない		
アニュス・デイ	名前-製品名-芸術名-音楽名			
ハイドン・セット	名前-製品名-芸術名-音楽名			
テレビドラマ	名前-製品名-芸術名-番組名	固有名詞ではない		
仮面ライダー555	名前-製品名-芸術名-番組名	名前-製品名-芸術名-映画名	名前-製品名-芸術名-文学名	???
仮面ライダーアギト	名前-製品名-芸術名-番組名	名前-製品名-芸術名-映画名	他に「主人公が変身するヒーローの名称」とある。人名？キャラクター名？	
仮面ライダー剣	名前-製品名-芸術名-番組名	名前-製品名-芸術名-映画名	他に「主人公が変身するヒーローの名称」とある。人名？キャラクター名？	
仮面ライダー響鬼	名前-製品名-芸術名-番組名	名前-製品名-芸術名-映画名	名前-製品名-芸術名-文学名	???
仮面ライダー龍騎	名前-製品名-芸術名-番組名	名前-製品名-芸術名-映画名		他に「主人公が変身するヒーローの名称」とある。人名？キャラクター名？
ジューンブライド	名前-製品名-芸術名-番組名	名前-製品名-芸術名-音楽名		
24時間テレビ 「愛は地球を救う」	名前-製品名-芸術名-番組名			
2時ワクッ!	名前-製品名-芸術名-番組名			
DRAMA COMPLEX	名前-製品名-芸術名-番組名			
ER緊急救命室	名前-製品名-芸術名-番組名			
FNSの日	名前-製品名-芸術名-番組名			
FNSスーパースペシャル1億人のテレビ夢列島	名前-製品名-芸術名-番組名			
FNSソフト工場	名前-製品名-芸術名-番組名			
FNSドキュメンタリー大賞	名前-製品名-芸術名-番組名			
FNS歌謡祭	名前-製品名-芸術名-番組名			
HOT6GOGO	名前-製品名-芸術名-番組名			
NHK大河ドラマ	名前-製品名-芸術名-番組名			
Qでん百科	名前-製品名-芸術名-番組名			
We Love 九州	名前-製品名-芸術名-番組名			
おもいっきりテレビ	名前-製品名-芸術名-番組名			
とんま天狗	名前-製品名-芸術名-番組名			
どちら様も!!笑ってヨロシク	名前-製品名-芸術名-番組名			
ひらけ!ポンキッキ	名前-製品名-芸術名-番組名			
ぼくらの時代	名前-製品名-芸術名-番組名			
みんなの挑戦物語	名前-製品名-芸術名-番組名			
めざましテレビ	名前-製品名-芸術名-番組名			
ダシヌキ!	名前-製品名-芸術名-番組名			
テレしず通りパロパロ	名前-製品名-芸術名-番組名			
ヒューマン九州21	名前-製品名-芸術名-番組名			
フルムーン旅情ミステリー	名前-製品名-芸術名-番組名			
ミッドナイトホラースクール	名前-製品名-芸術名-番組名			
ミレニアム2000〜きらめいて九州〜	名前-製品名-芸術名-番組名			
今、きらめいて	名前-製品名-芸術名-番組名			
山村美紗サスペンス 赤い霊柩車シリーズ	名前-製品名-芸術名-番組名			
徳川家康 (NHK大河ドラマ)	名前-製品名-芸術名-番組名			
忍風戦隊ハリケンジャー	名前-製品名-芸術名-番組名			
春の波濤	名前-製品名-芸術名-番組名			
春の波濤 (NHK大河ドラマ)	名前-製品名-芸術名-番組名			
機甲創世記モスピーダ	名前-製品名-芸術名-番組名			
火曜サスペンスクイズ	名前-製品名-芸術名-番組名			
狙え!キテレツひっと	名前-製品名-芸術名-番組名			
番頭はんと丁稚どん	名前-製品名-芸術名-番組名			
親子笑劇場電太郎一家	名前-製品名-芸術名-番組名			
走れ!ガリバーくん	名前-製品名-芸術名-番組名			
逃亡者木島丈一郎	名前-製品名-芸術名-番組名			
魔法戦隊マジレンジャー	名前-製品名-芸術名-番組名			
歴史小説	名前-製品名-芸術名-文学名	固有名詞ではない		
梟の城	名前-製品名-芸術名-文学名	名前-製品名-芸術名-映画名		
ファイブスター物語	名前-製品名-芸術名-文学名	名前-製品名-芸術名-映画名		
二つの祖国	名前-製品名-芸術名-文学名			
大地の子	名前-製品名-芸術名-文学名			
経典	名前-製品名-芸術名-文学名			
ザ・レジデント	名前-製品名-芸術名-文学名			
メスよ輝け!!	名前-製品名-芸術名-文学名			
青ひげは行く	名前-製品名-芸術名-文学名			
ハイジャック	名前-製品名-罪名			
強姦	名前-製品名-罪名			
領海侵犯	名前-製品名-罪名			
領空侵犯	名前-製品名-罪名			
シャーマニズム	名前-製品名-宗教名	名前-製品名-主義思想名		
平和主義	名前-製品名-主義思想名			
専守防衛	名前-製品名-主義思想名			
立憲主義	名前-製品名-主義思想名			
JJ	名前-製品名-出版物名-雑誌名	名前-人名	名前-組織名-企業名	
FNSアナウンス大賞	名前-製品名-賞名			
コンピューターゲーム	名前-製品名-製品名_その他	固有名詞ではない		
スクランブル	名前-製品名-製品名_その他	名前-製品名-芸術名-音楽名		
ホームワールド	名前-製品名-製品名_その他	名前-製品名-芸術名-音楽名		
CS★日テレ	名前-製品名-製品名_その他			
オロナインH軟膏	名前-製品名-製品名_その他			
ロマンシング サ・ガ	名前-製品名-製品名_その他			
戦車	名前-製品名-乗り物名-車名	固有名詞ではない		
自走砲	名前-製品名-乗り物名-車名	固有名詞ではない		
装甲戦闘車	名前-製品名-乗り物名-車名	固有名詞ではない		
装甲車	名前-製品名-乗り物名-車名	固有名詞ではない		
コスモ	名前-製品名-乗り物名-車名	名前-組織名-企業名	?他に「聖闘士星矢の中で登場人物が使う超自然的な力」とある	
90式戦車	名前-製品名-乗り物名-車名			
マウンテンバイク	名前-製品名-乗り物名-乗り物名_その他	固有名詞ではない		
ロードレーサー	名前-製品名-乗り物名-乗り物名_その他	固有名詞ではない		
ランドナー	名前-製品名-乗り物名-乗り物名_その他			
偵察機	名前-製品名-乗り物名-飛行機名	固有名詞ではない		
対潜哨戒機	名前-製品名-乗り物名-飛行機名	固有名詞ではない		
戦略爆撃機	名前-製品名-乗り物名-飛行機名	固有名詞ではない		
戦闘機	名前-製品名-乗り物名-飛行機名	固有名詞ではない		
支援戦闘機	名前-製品名-乗り物名-飛行機名	固有名詞ではない		
政府専用機	名前-製品名-乗り物名-飛行機名	固有名詞ではない		
早期警戒機	名前-製品名-乗り物名-飛行機名	固有名詞ではない		
空中給油機	名前-製品名-乗り物名-飛行機名	固有名詞ではない		
輸送機	名前-製品名-乗り物名-飛行機名	固有名詞ではない		
機雷戦艦艇	名前-製品名-乗り物名-船名	固有名詞ではない		
航空母艦	名前-製品名-乗り物名-船名	固有名詞ではない		
補給艦	名前-製品名-乗り物名-船名	固有名詞ではない		
軽空母	名前-製品名-乗り物名-船名	固有名詞ではない		
輸送艦	名前-製品名-乗り物名-船名	固有名詞ではない		
哨戒艦艇	名前-製品名-乗り物名-船名			
首都圏新都市鉄道TX-1000系電車	名前-製品名-乗り物名-列車名			
ミサイル	名前-製品名-武器名			
大陸間弾道ミサイル	名前-製品名-武器名			
手術	名前-製品名-方式制度名	固有名詞ではない		
量子論	名前-製品名-理論名			
NTTグループ	名前-組織名-企業グループ名			
信用金庫	名前-組織名-企業名	固有名詞ではない		
印刷会社	名前-組織名-企業名	固有名詞ではない		
BSフジ	名前-組織名-企業名			
NTV映像センター	名前-組織名-企業名			
さくらんぼテレビジョン	名前-組織名-企業名			
オムニバス・ジャパン	名前-組織名-企業名			
サガテレビ	名前-組織名-企業名			
テレパック	名前-組織名-企業名			
テレビ大分	名前-組織名-企業名			
テレビ宮崎	名前-組織名-企業名			
テレビ山口	名前-組織名-企業名			
テレビ山梨	名前-組織名-企業名			
テレビ愛媛	名前-組織名-企業名			
テレビ新広島	名前-組織名-企業名			
テレビ熊本	名前-組織名-企業名			
テレビ西日本	名前-組織名-企業名			
テレビ金沢	名前-組織名-企業名			
テレビ長崎	名前-組織名-企業名			
テレビ静岡	名前-組織名-企業名			
トランスビュー	名前-組織名-企業名			
フレンドマート	名前-組織名-企業名			
ユニオン映画	名前-組織名-企業名			
三重テレビ放送	名前-組織名-企業名			
京都放送	名前-組織名-企業名			
仙台放送	名前-組織名-企業名			
京王電鉄バス	名前-組織名-企業名			
北海道文化放送	名前-組織名-企業名			
北陸放送	名前-組織名-企業名			
名古屋市営バス	名前-組織名-企業名			
四国放送	名前-組織名-企業名			
大分放送	名前-組織名-企業名			
大映テレビ	名前-組織名-企業名			
奈良テレビ	名前-組織名-企業名			
宮崎放送	名前-組織名-企業名			
富山テレビ放送	名前-組織名-企業名			
山口放送	名前-組織名-企業名			
山口朝日放送	名前-組織名-企業名			
山形テレビ	名前-組織名-企業名			
山形放送	名前-組織名-企業名			
山梨放送	名前-組織名-企業名			
山陰中央テレビジョン放送	名前-組織名-企業名			
岡山放送	名前-組織名-企業名			
岩手めんこいテレビ	名前-組織名-企業名			
広島テレビ放送	名前-組織名-企業名			
庄司永建	名前-組織名-企業名			
新潟総合テレビ	名前-組織名-企業名			
日企	名前-組織名-企業名			
日本海テレビジョン放送	名前-組織名-企業名			
札幌テレビ放送	名前-組織名-企業名			
愛知環状鉄道	名前-組織名-企業名			
東海ラジオ放送	名前-組織名-企業名			
法蔵館	名前-組織名-企業名			
沖縄テレビ放送	名前-組織名-企業名			
熊本県民テレビ	名前-組織名-企業名			
石川テレビ放送	名前-組織名-企業名			
福島テレビ	名前-組織名-企業名			
福島中央テレビ	名前-組織名-企業名			
秋田テレビ	名前-組織名-企業名			
秋田放送	名前-組織名-企業名			
長崎国際テレビ	名前-組織名-企業名			
長野放送	名前-組織名-企業名			
青森テレビ	名前-組織名-企業名			
青森放送	名前-組織名-企業名			
青森朝日放送	名前-組織名-企業名			
高知さんさんテレビ	名前-組織名-企業名			
鹿児島テレビ放送	名前-組織名-企業名			
鹿児島讀賣テレビ	名前-組織名-企業名			
日本喜劇人協会	名前-組織名-協会名			
近代映画協会	名前-組織名-協会名			
アメリカ空軍	名前-組織名-軍隊名			
佐世保地方隊	名前-組織名-軍隊名			
呉地方隊	名前-組織名-軍隊名			
在日米軍	名前-組織名-軍隊名			
大湊地方隊	名前-組織名-軍隊名			
日本海軍	名前-組織名-軍隊名			
日本陸軍	名前-組織名-軍隊名			
横須賀地方隊	名前-組織名-軍隊名			
自衛艦隊	名前-組織名-軍隊名			
舞鶴地方隊	名前-組織名-軍隊名			
航空総隊	名前-組織名-軍隊名			
特攻隊	名前-組織名-軍隊名			
GHQ	名前-組織名-政府組織名			
ハノーファー王国	名前-組織名-政府組織名			
唐	名前-組織名-政府組織名			
国会	名前-組織名-政府組織名			
特高警察	名前-組織名-政府組織名			
SACO	名前-組織名-組織名_その他			
Wink	名前-組織名-組織名_その他			
アマデウス弦楽四重奏団	名前-組織名-組織名_その他			
アルデッティ弦楽四重奏団	名前-組織名-組織名_その他			
アルバン・ベルク弦楽四重奏団	名前-組織名-組織名_その他			
イタリア弦楽四重奏団	名前-組織名-組織名_その他			
ウィーン・コンツェルトハウス弦楽四重奏団	名前-組織名-組織名_その他			
エマーソン弦楽四重奏団	名前-組織名-組織名_その他			
クロノス・カルテット	名前-組織名-組織名_その他			
ゲヴァントハウス弦楽四重奏団	名前-組織名-組織名_その他			
コダーイ弦楽四重奏団	名前-組織名-組織名_その他			
ジュリアード弦楽四重奏団	名前-組織名-組織名_その他			
ハーゲン弦楽四重奏団	名前-組織名-組織名_その他			
バリリ弦楽四重奏団	名前-組織名-組織名_その他			
バルトーク弦楽四重奏団	名前-組織名-組織名_その他			
ブタペスト弦楽四重奏団	名前-組織名-組織名_その他			
ボロディン弦楽四重奏団	名前-組織名-組織名_その他			
メロス弦楽四重奏団	名前-組織名-組織名_その他			
ラサール弦楽四重奏団	名前-組織名-組織名_その他			
ヴェラー弦楽四重奏団	名前-組織名-組織名_その他			
安全地帯	名前-組織名-組織名_その他			
東京カルテット	名前-組織名-組織名_その他			
統合幕僚会議	名前-組織名-組織名_その他			
消防	名前-組織名-組織名_その他			
青森営林局	名前-組織名-組織名_その他			
堅田藩	名前-地名-GPE-GPE_その他			
大和国	名前-地名-GPE-GPE_その他			
松岡藩 (常陸国)	名前-地名-GPE-GPE_その他			
上伊那郡	名前-地名-GPE-群名			
東牟婁郡	名前-地名-GPE-群名			
磯城郡	名前-地名-GPE-群名			
秩父郡	名前-地名-GPE-群名			
諏訪郡	名前-地名-GPE-群名			
パームスプリングス	名前-地名-GPE-市区町村名			
上尾市	名前-地名-GPE-市区町村名			
下諏訪町	名前-地名-GPE-市区町村名			
串本町	名前-地名-GPE-市区町村名			
南あわじ市	名前-地名-GPE-市区町村名			
可児市	名前-地名-GPE-市区町村名			
小千谷市	名前-地名-GPE-市区町村名			
岡崎市	名前-地名-GPE-市区町村名			
岡谷市	名前-地名-GPE-市区町村名			
新居浜市	名前-地名-GPE-市区町村名			
新潟市	名前-地名-GPE-市区町村名			
有田市	名前-地名-GPE-市区町村名			
東山区	名前-地名-GPE-市区町村名			
東温市	名前-地名-GPE-市区町村名			
横須賀市	名前-地名-GPE-市区町村名			
浜松市	名前-地名-GPE-市区町村名			
熊本市	名前-地名-GPE-市区町村名			
田原本町	名前-地名-GPE-市区町村名			
甲賀市	名前-地名-GPE-市区町村名			
篠山市	名前-地名-GPE-市区町村名			
能登川町	名前-地名-GPE-市区町村名			
草加市	名前-地名-GPE-市区町村名			
葛城市	名前-地名-GPE-市区町村名			
辰野町	名前-地名-GPE-市区町村名			
長瀞町	名前-地名-GPE-市区町村名			
青森市	名前-地名-GPE-市区町村名			
鶴岡市	名前-地名-GPE-市区町村名			
奈良	名前-地名-GPE-都道府県州名	名前-地名-GPE-市区町村名	名前-人名	時間表現-時間-時代表現
広島	名前-地名-GPE-都道府県州名	名前-地名-GPE-市区町村名	名前-施設名-GOE-駅名-電車駅名	名前-地名-地形名-陸上地形名
沖縄	名前-地名-GPE-都道府県州名	名前-地名-GPE-市区町村名	名前-地名-地形名-陸上地形名	
レバント	名前-地名-大陸地域名			
新北区	名前-地名-大陸地域名			
ローレライ	名前-地名-地形名-陸上地形名	名前-製品名-芸術名-音楽名	名前-製品名-武器名	名前-製品名-芸術名-映画名
サンジャシント山脈	名前-地名-地形名-陸上地形名			
リトル東京	名前-地名-地名_その他			
川内インターチェンジ	名前-地名-地名_その他			
慢性消化器病	名前-病気名			
運動麻痺	名前-病気名			
